eye: pie, oca, asta, cola, gota
ear: hornear, ayer, eso, meter, verter
nose: nido, nudo, nube, nadar, nuevo
mouth: animal, meter, grave, ayer, once
tooth: toalla, orilla, muchacho, menear, hornear
tongue: tintinear, tía, taza, tumba, tío
lip: meter, oler, ayer, pez, pie
cheek: pecho, irse, oveja, bigote, gancho
face: meter, pie, grave, once, idea
forehead: hornear, revolver, multicolor, muchacho, longitud
hair: animal, ayer, eso, meter, pie
moustache: marcharse, marcha, morder, madera, manta
beard: beber, muchacho, menear, muchacha, oveja
chin: oler, irse, ayer, tan, asar
jaw: placer, ayer, eso, meter, irse
throat: animal, meter, grave, verter, ayer
neck: meter, ayer, verter, animal, eso
nape: nube, nido, nudo, nadar, norte
head: meter, animal, oca, cola, ayer
back: ayer, meter, once, eso, irse
spine: pluma, moverse, prado, impeler, pieza
belly: menear, hornear, helada, caliente, bigote
navel: revolver, padres, tapadera, padre, multicolor
bosom: bosque, menear, lonja, mosca, hornear
chest: meter, animal, eso, pie, ayer
breast: irse, liebre, trepar, reptar, hornear
shoulder: muchacho, menear, once, padres, mayo
arm: meter, oca, eso, irse, ayer
elbow: ellos, rodilla, delgado, caliente, helada
hand: animal, meter, pie, red, ayer
palm: pino, paso, pala, pender, pueblo
finger: meter, ayer, pie, animal, eso
fingernail: fresco, felicidad, frotar, fusil, fuego
nail: nadar, nido, nudo, nube, nacer
toe: toalla, orilla, oca, noventa, no
foot: meter, animal, eso, ayer, grave
heel: ayer, meter, eso, verter, irse
knee: hilo, jefe, diente, hongo, madera
thigh: hornear, revolver, zorro, menear, ayer
leg: meter, verter, ayer, eso, oler
body: animal, oca, cola, meter, idea
skin: animal, eso, meter, oca, cola
blood: animal, red, grave, meter, eso
vein: veinte, oveja, ave, irse, poseer
sinew: sin filo, coser, gancho, tan, lonja
bone: grave, pie, animal, bote, meter
brain: animal, meter, eso, ayer, pie
heart: animal, ayer, meter, eso, grave
stomach: revolver, menear, hornear, hurtar, tomar
liver: llover, lamer, lazo, largo, luz
breath: irse, trepar, reptar, liebre, rebanada
hunger: hambre, hilo, hongo, huevo, hombre
tear: techo, teñir, irse, pecho, peinar
flavour: fluir, flor, multicolor, revolver, crudo
odour: ayer, vidrio, poseer, meter, arder
sleep: animal, meter, eso, ayer, pie
dream: ayer, irse, eso, meter, idea
sky: rey, irse, ayer, eso, asta
sun: irse, ayer, eso, meter, sol
moon: ayer, meter, irse, pie, animal
star: dar, ayer, irse, meter, asar
air: aire, meter, animal, placer, eso
wind: meter, animal, ayer, red, eso
wave: pie, meter, grave, cola, idea
water: animal, meter, placer, pie, ayer
stone: placer, grave, animal, pie, asta
soil: soporte, muchacho, soportar, once, oreja
ground: meter, animal, red, pie, grave
earth: animal, eso, ayer, meter, grave
dust: meter, placer, animal, eso, ayer
smoke: revolver, pie, zorro, jefe, irse
spark: meter, asar, oca, ayer, cola
fire: animal, meter, grave, red, pie
light: meter, animal, idea, eso, ayer
shadow: ayer, eso, meter, irse, animal
weather: ayer, meter, oca, asta, irse
fog: fresco, fuego, foso, fregar, fino
cloud: meter, oca, idea, pie, animal
rain: meter, ayer, irse, eso, once
snow: ayer, meter, irse, rey, eso
ice: pie, grave, eso, oca, meter
frost: fresco, fuego, foso, fregar, fino
chill: chico, chica, chispear, chispa, zorro
heat: meter, animal, cola, pie, mono
hoarfrost: hoja, ganso, gusano, hongo, rojo
rainbow: bigote, revolver, multicolor, redondo, menear
thunder: zorro, revolver, ayer, menear, hornear
current: final, oca, no, meter, idea
drop: meter, eso, final, once, ayer
foam: cola, nuca, oca, foso, trazo
dirt: diente, dios, dolor, doler, dormir
lake: gota, rico, raya, asta, familia
swamp: zorro, revolver, maduro, hornear, bigote
moor: mojado, mostrar, rico, hongo, oca
meadow: mejilla, bigote, menear, oveja, bandada
forest: animal, ayer, oca, meter, irse
hill: ayer, irse, animal, eso, meter
elevation: echar, elegir, oca, idea, asta
mountain: bigote, montaña, redondo, caliente, caldera
summit: sumergirse, padres, revolver, prometer, ayer
cave: caverna, cuna, cuesta, cruz, codo
slope: meter, pie, grave, cola, idea
source: todo, idea, meter, final, error
brook: ayer, rey, irse, eso, rico
river: ayer, meter, placer, gota, irse
shore: ayer, meter, irse, eso, grave
coast: oca, coleccionar, rojo, costado, tronco
land: ayer, animal, meter, placer, irse
sea: cola, oca, asta, gota, asa
cove: cuna, coger, cruz, codo, cima
island: isla, muchacho, menear, orilla, caliente
flower: animal, pie, ayer, grave, meter
grass: animal, meter, red, ayer, grave
root: tabla, meter, todo, oca, cola
tree: pie, animal, cola, oca, grave
trunk: trazo, tragar, trampa, trabajo, triste
bark: baya, bello, bajo, bota, bajar
limb: limpio, limpiar, prometer, impeler, meter
branch: oca, meter, ayer, idea, eso
leaf: animal, pie, meter, ayer, cola
birch: firme, ayer, hornear, barullo, azul
pine: pie, grave, oca, red, cola
willow: menear, muchacho, mayo, ayer, hornear
fir: firme, ir, irse, ayer, asar
horn: hornear, ayer, meter, irse, verter
feather: febrero, pieza, firme, maestro, pecho
fur: ayer, oler, irse, pez, asar
wing: ayer, meter, irse, rey, eso
claw: clavo, clase, revolver, zorro, hornear
tail: meter, pie, animal, verter, ayer
egg: pie, animal, cola, meter, ayer
nest: meter, ayer, oca, irse, idea
lair: llover, lamer, lazo, luz, luego
animal: animal, eso, ayer, grave, meter
flock: foso, fresco, fuego, fregar, fino
cow: animal, ayer, pie, irse, rey
bull: ayer, hornear, irse, animal, pez
horse: animal, grave, pie, irse, meter
sheep: menear, oveja, muchacho, bandada, irse
pig: animal, ayer, pie, meter, irse
dog: animal, ayer, pie, irse, pez
cat: animal, ayer, oca, meter, ratón
bear: animal, ayer, hornear, menear, irse
squirrel: sauce, sopa, saber, silla, sordo
elk: ellos, helada, jefe, caliente, azul
fox: ayer, irse, eso, oca, animal
hare: irse, ayer, meter, rey, gota
mouse: animal, meter, pie, cola, mono
wolf: animal, ayer, irse, rey, rico
bird: animal, ayer, grave, eso, irse
swarm: oscuro, revolver, prometer, zorro, ascender
chicken: chico, chica, chispa, chispear, madurar
cock: ayer, irse, rey, eso, hornear
goose: bigote, cueva, muchacho, tronco, tapadera
eagle: echar, elegir, oca, asta, madera
duck: animal, ayer, irse, pez, meter
owl: animal, ayer, irse, oca, eso
crane: crudo, prado, trineo, tronco, grulla
crow: ayer, irse, rey, eso, pez
cuckoo: caverna, cabello, cuchara, coger, cuchillo
swan: zorro, menear, hornear, revolver, irse
fish: animal, ayer, meter, pie, irse
perch: percha, perca, perro, perder, revolver
pike: oca, irse, todo, asar, pie
snake: animal, pie, grave, cola, meter
worm: animal, meter, ayer, pie, verter
spider: revolver, impeler, zorro, oscuro, tapadera
ant: antiguo, eso, oler, irse, atar
louse: llover, lamer, lazo, largo, luna
midge: manta, madera, morder, muelle, manga
fly: meter, ayer, irse, eso, animal
butterfly: bello, baya, barrer, brazo, boca
berry: ayer, rey, oca, rico, pie
apple: oca, pie, cola, ayer, meter
mushroom: mango, marcharse, madera, marcha, morder
onion: muchacho, ayer, meter, pasto, multicolor
seed: animal, meter, oca, cola, ayer
grain: grano, grasa, gritar, grulla, grande
hay: ayer, rey, irse, oler, eso
husk: muslo, hornear, humear, menear, ayer
pit: ayer, meter, oler, eso, pez
trap: meter, ayer, verter, once, eso
noose: no, noventa, noche, muchacho, bigote
track: meter, idea, ayer, oca, eso
ashes: ayer, irse, once, eso, oca
filth: afilado, polvo, revolver, helada, menear
iron: placer, red, animal, meter, eso
gold: placer, red, ayer, animal, oreja
silver: red, placer, ayer, redondo, meter
coal: placer, animal, oreja, eso, sol
glass: meter, red, fabricar, placer, animal
clay: clavo, clase, caliente, fluir, multicolor
sand: placer, meter, ayer, animal, pez
human: animal, eso, no, familia, meter
man: mano, manzana, menear, manantial, ayer
woman: menear, animal, eso, mano, once
child: animal, eso, once, ayer, grave
boy: rey, ayer, menear, irse, animal
girl: menear, animal, ayer, once, irse
family: animal, familia, ayer, oca, irse
grandfather: bigote, maduro, muchacho, redondo, ayer
grandmother: bigote, maduro, menear, muchacho, hermana
parents: once, oca, ayer, menear, idea
father: ayer, rico, once, rey, irse
mother: ayer, once, eso, irse, rey
son: sonido, sonar, ayer, oler, irse
daughter: ayer, once, raya, irse, familia
brother: robar, rojo, menear, revolver, ayer
sister: saber, sopa, sauce, silla, sordo
uncle: bigote, menear, maduro, cesar, muchacho
aunt: aún, afluir, a veces, año, hermana
husband: menear, ayer, humear, muslo, mentira
wife: raya, once, ayer, rico, gota
joy: rey, ayer, irse, rico, eso
laughter: ayer, irse, eso, once, animal
happiness: hilo, hambre, hongo, hombre, huevo
grief: ganas, gusto, gato, ganso, gusano
wish: once, ayer, eso, irse, oca
desire: después, desear, desgracia, despertar, despertarse
spirit: ayer, animal, meter, irse, eso
thought: once, idea, meter, eso, ayer
memory: meter, idea, memoria, cola, animal
mind: ayer, meter, eso, once, irse
meaning: once, idea, ayer, eso, meter
reason: once, ayer, eso, idea, meter
truth: ayer, once, irse, eso, meter
talk: irse, oca, meter, ayer, idea
fairy tale: fresco, fuego, famoso, foso, fregar
story: ayer, idea, irse, oca, meter
message: error, todo, mensaje, idea, recordar
news: oca, idea, asa, abajo, irse
name: tabla, todo, nombre, cola, final
puzzle: pino, poder, pato, paso, pueblo
speech: meter, animal, idea, eso, ayer
language: idea, todo, oca, animal, tabla
voice: idea, oca, pie, meter, eso
word: meter, ayer, animal, idea, cola
sign: significado, eso, meter, once, idea
call: idea, meter, final, oca, ayer
noise: pie, meter, cola, idea, grave
sound: meter, animal, idea, eso, ayer
tone: pie, meter, irse, bote, ayer
song: ayer, meter, once, irse, pie
calm: calma, caliente, caldera, calor, caluroso
people: once, menear, ayer, oca, idea
nation: ayer, oca, irse, meter, once
work: meter, idea, ayer, once, oca
guest: oca, ayer, irse, asta, idea
gift: ayer, oca, idea, meter, irse
game: todo, cola, pie, tabla, oca
company: oca, idea, asta, eso, ayer
help: error, idea, oca, meter, todo
friend: ayer, once, irse, oca, meter
companion: comer, comida, comarca, comprar, comprender
matter: meter, ayer, verter, once, eso
count: meter, correcto, tabla, once, vara
sort: meter, vara, final, ayer, verter
piece: meter, pie, ayer, idea, once
part: parte, partir, participar, eso, meter
half: once, meter, eso, red, ayer
circle: meter, pie, ayer, idea, cola
cross: meter, animal, eso, ayer, irse
line: meter, pie, cola, idea, oca
stroke: pie, animal, meter, grave, oca
gap: meter, ayer, oca, eso, asar
distance: meter, idea, oca, cola, tabla
area: arena, oca, idea, cola, asta
space: meter, grave, oca, pie, irse
place: once, oca, idea, meter, ayer
side: pie, meter, grave, idea, oca
middle: ayer, meter, irse, eso, oca
item: meter, todo, oca, idea, cola
thing: once, ayer, meter, verter, irse
fringe: frío, frontera, crudo, prado, trampa
edge: meter, idea, pie, oca, cola
corner: meter, red, ayer, idea, animal
tip: meter, ayer, pie, oca, irse
end: meter, verter, eso, once, no
hole: meter, pie, ayer, grave, animal
angle: meter, tabla, pie, cola, error
pattern: idea, meter, cola, tabla, todo
size: meter, cola, tabla, idea, pie
length: meter, correcto, vara, final, cola
height: meter, tabla, cola, idea, final
weight: meter, cola, idea, ayer, animal
amount: once, meter, oca, cola, correcto
heap: meter, todo, cola, tabla, oca
row: meter, ayer, cola, tabla, oca
boat: animal, meter, ayer, oca, caro
oar: oeste, o, ojo, ocho, oír
sleigh: silla, sauce, saber, sopa, sordo
ski: asta, oca, gota, asa, raya
campfire: caliente, bigote, barullo, muchacho, bandada
load: final, error, tabla, todo, seta
walk: meter, ayer, irse, once, oca
step: meter, ayer, eso, once, pie
north: ayer, red, irse, rey, asta
south: ayer, irse, red, rey, asta
west: ayer, irse, rey, asta, rico
east: ayer, irse, asta, rey, oca
wood: red, placer, animal, meter, ayer
board: meter, oca, cola, tabla, todo
slab: revolver, fluir, multicolor, prado, padres
bracket: brillar, trazo, llaga, barrer, trampa
pole: meter, ayer, pie, irse, asta
stick: meter, animal, pie, red, ayer
staff: oca, eso, ayer, irse, meter
pipe: pie, meter, pieza, cola, asta
house: grave, animal, oca, meter, ayer
home: oca, idea, asa, asta, arena
stove: bigote, revolver, barato, barca, ventana
floor: meter, pie, idea, animal, fabricar
table: tabla, cola, meter, todo, idea
chair: ayer, meter, eso, asta, idea
cradle: crudo, prado, trineo, zorro, gritar
bed: meter, ayer, red, pie, eso
shelf: meter, idea, animal, eso, ayer
box: meter, pie, cola, oca, ayer
window: cola, todo, tabla, oro, oca
door: meter, ayer, eso, asta, idea
gate: meter, pie, oca, ayer, irse
fence: fresco, fuego, foso, fregar, fino
roof: meter, placer, animal, pie, grave
ladder: lazo, lamer, largo, luna, llover
broom: bello, baya, bajo, bota, bajar
spade: impeler, tapadera, prado, trineo, maestro
shovel: revolver, zorro, menear, hornear, hurtar
fork: meter, ayer, pie, verter, oca
spoon: revolver, impeler, tapadera, zorro, ganas
knife: pie, cola, oca, meter, idea
net: meter, oca, asar, ayer, sol
hook: todo, cola, meter, tabla, error
handle: meter, idea, todo, once, no
lock: meter, ayer, eso, idea, once
picture: idea, ayer, oca, meter, irse
figure: figura, idea, meter, cola, oca
doll: ayer, irse, animal, eso, pez
pouch: pino, poder, paso, pender, pueblo
bundle: todo, tabla, meter, error, idea
bag: ayer, meter, pie, irse, pez
bucket: meter, ayer, pie, cola, idea
cover: ayer, imagen, oca, irse, eso
dishes: diente, dios, doler, dolor, dormir
sack: sauce, sopa, saber, silla, sombra
cup: meter, pie, ayer, oca, irse
pot: potencia, ayer, oler, pie, meter
kettle: ganas, zorro, jefe, gusto, ganso
meal: pie, meter, cola, animal, oca
food: animal, pie, oca, ayer, meter
dish: meter, ayer, oca, irse, pie
meat: mejilla, sauce, pie, oveja, muchacho
corn: pez, pie, ayer, hornear, placer
mush: morder, manta, mecer, madera, muelle
bread: pie, ayer, animal, meter, oca
slice: pie, cola, pieza, meter, oca
fat: fatigarse, animal, ayer, meter, eso
butter: bello, baya, bota, bajar, boca
oil: placer, animal, meter, cola, pie
salt: saltar, cola, meter, pie, oca
soup: pie, ayer, oca, sauce, irse
honey: huevo, hongo, hilo, hombre, hambre
milk: mango, madera, manta, manga, mecer
tea: cola, oca, asta, raya, gota
leather: leche, leer, letra, lechuza, barato
wool: menear, bigote, barca, rojo, polvo
cloth: animal, fabricar, meter, ayer, eso
needle: meter, animal, pie, cola, grave
thread: meter, pie, idea, error, cola
button: oca, todo, cola, botón, tabla
knot: zorro, ganas, tintinear, jefe, hurtar
paint: meter, idea, pie, ayer, oca
clothes: menear, barato, barullo, barca, zorro
shirt: ayer, meter, pie, irse, oca
collar: colgar, colina, hornear, llaga, multicolor
sleeve: sauce, sopa, silla, sensato, sueño
trousers: tragar, trampa, trazo, triste, trueno
belt: meter, placer, ayer, eso, asta
cap: ayer, meter, oca, irse, eso
shoe: bigote, barca, jefe, zorro, menear
boot: meter, ayer, oca, irse, pie
ring: meter, pie, ayer, verter, eso
ribbon: meter, pie, oca, cola, ayer
comb: combate, meter, oca, cola, eso
mirror: meter, idea, ayer, fabricar, eso
strap: meter, ayer, tapadera, oca, verter
string: vara, final, tabla, meter, error
leash: leer, leche, letra, llevar, menear
blanket: bigote, padres, multicolor, tapadera, barullo
pillow: revolver, padres, bigote, multicolor, tapadera
scarf: barullo, barca, hornear, menear, barbilla
towel: taza, tubo, tumba, tapa, tonto
force: meter, once, idea, eso, oca
strength: meter, once, eso, idea, ayer
health: animal, oca, eso, irse, ayer
illness: mentira, once, allí, eso, menear
pain: animal, ayer, eso, irse, meter
wound: hurtar, fresco, ganas, hilo, impeler
fever: febrero, irse, revolver, pecho, calma
medicine: oca, animal, idea, ayer, meter
bridge: oca, meter, asta, idea, pie
well: once, eso, ayer, meter, irse
pasture: pasto, bandada, muchacho, animal, caliente
path: meter, tabla, error, todo, distinto
way: ayer, once, irse, meter, verter
road: animal, meter, grave, ayer, irse
village: valla, vago, vender, viento, vaca
town: ayer, irse, oca, once, meter
letter: meter, ayer, idea, pie, oca
book: ayer, irse, idea, oca, meter
character: idea, meter, animal, ayer, eso
newspaper: padres, revolver, multicolor, menear, barca
life: idea, oca, eso, grave, asta
death: animal, ayer, grave, eso, once
grave: grave, pie, ayer, irse, gota
church: oca, ayer, irse, grave, eso
sin: tan, sin filo, irse, vara, sol
god: ayer, rey, eso, irse, once
worker: todo, oca, cola, meter, animal
boss: ayer, oca, irse, rico, asta
master: meter, ayer, eso, asta, irse
doctor: ayer, irse, oca, eso, rico
teacher: ayer, oca, eso, animal, irse
money: meter, ayer, animal, oca, idea
business: idea, oca, eso, ayer, irse
shop: ayer, oca, idea, asta, irse
price: precio, idea, pie, cola, oca
ware: irse, ayer, meter, eso, verter
profit: ayer, meter, eso, idea, irse
wealth: eso, irse, ayer, animal, once
world: animal, ayer, oca, irse, idea
country: animal, meter, oca, ayer, idea
state: oca, meter, asa, animal, idea
king: ayer, rey, irse, rico, eso
power: meter, idea, eso, pie, ayer
border: meter, oca, ayer, animal, grave
war: dar, asar, ayer, irse, atar
enemy: meter, animal, once, cola, oca
violence: violencia, mentira, sentir, declive, once
fight: once, ayer, eso, irse, meter
bow: ayer, meter, irse, eso, pie
arrow: abajo, imagen, oca, ayer, meter
gun: animal, ayer, irse, meter, pez
mistake: mentira, menear, muchacho, ayer, poseer
lie: liebre, pie, eso, irse, ave
damage: meter, idea, once, oca, eso
misfortune: mentira, muchacho, ayer, fundirse, ensueño
fault: meter, eso, error, idea, verter
age: pie, meter, oca, once, ave
conclusion: conducir, conversación, congregarse, concebir, conversar
time: meter, pie, idea, cola, once
day: ayer, meter, once, irse, oca
morning: morir, maduro, muchacho, madurar, barullo
noon: ayer, irse, oca, raya, eso
evening: muchacho, once, menear, allí, ayer
night: animal, ayer, eso, grave, meter
week: ayer, eso, oca, meter, once
month: meter, tabla, oca, cola, ayer
year: meter, ayer, once, oca, irse
spring: oca, pie, meter, ayer, cola
summer: ayer, oca, animal, raya, eso
autumn: multicolor, revolver, menear, marcharse, caliente
winter: animal, ayer, oca, irse, red
January: noviembre, octubre, marzo, Estado, oca
February: noviembre, marzo, octubre, Estado, oca
March: noviembre, marzo, octubre, irse, mar
April: noviembre, Estado, marzo, rey, octubre
May: mayo, rey, ayer, mar, eso
June: noviembre, irse, Estado, asta, rey
July: noviembre, marzo, octubre, Estado, agosto
August: noviembre, octubre, irse, orilla, ayer
September: noviembre, octubre, marzo, Estado, eso
October: noviembre, octubre, marzo, Estado, irse
November: noviembre, octubre, marzo, Estado, oca
December: noviembre, octubre, marzo, Estado, oca
Monday: ayer, eso, irse, Estado, onda
Tuesday: ayer, eso, irse, onda, grave
Wednesday: ayer, eso, irse, grave, oca
Thursday: ayer, eso, irse, onda, pie
Friday: ayer, Estado, pie, rey, grave
Saturday: ayer, eso, onda, oca, irse
Sunday: grave, Estado, ayer, uno, pie
big: bigote, red, ayer, meter, rey
little: ayer, bigote, eso, rey, red
long: longitud, meter, ayer, once, eso
short: longitud, meter, eso, ayer, animal
wide: meter, pie, grave, idea, eso
narrow: nudo, nadar, nido, nuevo, norte
dense: meter, animal, cola, mono, pie
thick: multicolor, ayer, bigote, hornear, zorro
thin: meter, eso, red, pie, oca
delicate: delgado, delicado, delante de, caliente, calma
firm: ayer, oca, eso, once, irse
flat: meter, red, pie, animal, ayer
smooth: meter, ayer, multicolor, red, eso
hard: red, meter, animal, eso, ayer
soft: red, meter, eso, ayer, animal
round: red, meter, multicolor, eso, ayer
pointed: meter, costado, multicolor, longitud, sentido
sharp: ayer, eso, asta, meter, oca
blunt: blanco, revolver, fluir, llaga, trampa
heavy: meter, animal, eso, placer, no
beautiful: ayer, once, eso, idea, bigote
hot: ayer, eso, meter, asta, pie
warm: red, ayer, once, meter, animal
cold: red, animal, placer, meter, eso
cool: ayer, animal, idea, meter, red
fresh: ayer, eso, oca, once, idea
damp: doler, diente, dios, dolor, dormir
wet: hilo, ganas, hongo, hurtar, bello
dry: red, placer, meter, animal, ayer
full: final, no, meter, animal, red
empty: final, meter, cola, oca, idea
open: final, idea, error, eso, meter
closed: meter, eso, once, ayer, oca
clean: idea, meter, oca, cola, no
dirty: ayer, rey, bigote, red, animal
raw: animal, meter, ayer, red, oca
ripe: oca, eso, pie, asta, cola
delicious: delgado, delicado, delante de, caliente, adelante
sweet: ayer, rey, red, bigote, animal
bitter: bello, baya, bajar, bajo, boca
sour: sauce, saber, sopa, silla, siete
bright: red, ayer, meter, animal, asta
dark: red, animal, grave, ayer, meter
black: red, redondo, ayer, bigote, animal
white: red, redondo, pie, grave, bigote
red: red, redondo, ayer, rey, asta
yellow: red, redondo, ayer, multicolor, bigote
blue: red, redondo, pie, asta, bigote
green: red, redondo, oca, asta, ayer
grey: red, redondo, rey, ayer, bigote
colourful: multicolor, fabricar, bigote, animal, redondo
cheap: ayer, asta, idea, onda, eso
dear: de nuevo, dejar, de repente, decrecer, destruir
precious: precioso, oscuro, multicolor, encolar, decir
blind: ayer, animal, eso, meter, once
deaf: de nuevo, dejar, decrecer, irse, de repente
powerful: meter, muchacho, idea, multicolor, revolver
strong: eso, meter, no, ayer, once
weak: meter, eso, no, animal, once
slim: revolver, fluir, multicolor, zorro, prado
pretty: ayer, once, idea, red, pie
evil: ayer, eso, irse, animal, once
stupid: revolver, madurar, jefe, zorro, bigote
lazy: final, idea, todo, pie, meter
diligent: diligente, doler, deteriorar, diente, dormir
stingy: revolver, menear, jactarse, hurtar, bigote
clever: irse, prometer, menear, ayer, robar
skilful: menear, hornear, rebullir, jactarse, silbar
merry: madera, morder, mecer, manta, muelle
gentle: menear, muchacho, ayer, herida, hornear
hungry: bigote, maduro, madurar, revolver, padres
sick: sauce, sopa, saber, silla, sombra
naked: nudo, nadar, nido, nube, nacer
sad: ayer, madurar, irse, once, eso
living: animal, once, ayer, eso, irse
good: eso, ayer, once, no, animal
bad: ayer, no, meter, animal, irse
correct: correcto, meter, no, final, idea
nasty: nadar, nudo, nido, nube, nacer
true: once, grave, eso, oca, idea
old: ayer, oca, eso, irse, once
new: final, idea, ayer, eso, oca
former: eso, once, ayer, oca, irse
aged: ayer, once, eso, oler, animal
young: ayer, eso, once, rey, irse
poor: pozo, oca, maestro, gota, no
rich: ayer, irse, rey, oler, eso
familiar: fresco, foso, fregar, fuego, fino
famous: fresco, fuego, foso, fino, fregar
foreign: animal, oca, eso, no, ayer
different: eso, meter, idea, once, no
near: once, ayer, eso, irse, imagen
far: dar, asar, mar, regar, atar
left: once, meter, oca, final, no
right: meter, once, idea, ayer, no
other: eso, once, no, idea, meter
first: final, no, once, oca, idea
second: final, eso, no, once, meter
third: eso, meter, final, ayer, once
last: final, once, no, ayer, eso
alone: once, ayer, eso, irse, oca
at once: orilla, andar, once, toalla, atrapar
together: toalla, once, orilla, noticia, sentido
suddenly: sauce, sopa, silla, saber, sombra
instantly: muchacho, muchacha, once, justo, noticia
later: once, oler, ayer, verter, eso
now: once, ayer, eso, irse, meter
today: once, ayer, oca, irse, eso
tomorrow: tomar, menear, rogar, cesar, ayer
soon: once, ayer, eso, oler, irse
then: once, eso, andar, oler, orilla
yesterday: y, yacer, once, ahora, ayer
once: once, eso, ave, ayer, irse
at that time: orilla, andar, once, a causa de, a través de
afterwards: once, orilla, andar, sentarse, toalla
before: once, no, final, meter, idea
at first: orilla, andar, once, allí, atrapar
sometimes: once, eso, idea, ayer, no
often: once, eso, orilla, notar, andar
always: once, eso, noticia, notar, ayer
never: once, eso, noticia, notar, ayer
here: once, ayer, eso, irse, oca
hither: hilo, hongo, hambre, hoy, hurtar
hence: haz, heno, hongo, hoy, hijo
there: once, eso, ave, irse, ayer
thither: ayer, jactarse, sentarse, oler, llover
ahead: once, ayer, meter, eso, idea
forward: meter, once, no, oca, ayer
backward: eso, oca, abajo, o, irse
below: once, eso, ayer, meter, verter
down: meter, once, ayer, eso, irse
above: once, idea, meter, oca, eso
up: meter, ayer, irse, once, asar
everywhere: once, muchacho, allí, ayer, idea
not: notar, noticia, once, eso, no
a little: a solo, a veces, aún, a menudo, a causa de
hardly: muchacho, once, muchacha, menear, notar
very: once, eso, ayer, muchacha, muchacho
so: soporte, once, soportar, eso, no
still: once, eso, ayer, muchacho, noticia
only: once, eso, ayer, notar, noticia
already: once, eso, noticia, notar, justo
again: once, ayer, eso, verter, irse
in vain: orilla, allí, andar, once, invierno
in front of: orilla, allí, a través de, andar, toalla
behind: hurtar, ayer, once, menear, sentir
under: once, ayer, eso, meter, irse
through: once, eso, idea, ayer, orilla
next to: orilla, toalla, allí, once, sentido
between: once, eso, no, orilla, idea
because of: once, orilla, andar, toalla, eso
this: once, idea, oca, ayer, eso
that: once, eso, andar, ayer, orilla
everything: once, ayer, eso, idea, irse
I: y, eso, ave, once, mar
you: once, eso, ayer, notar, irse
thou: ayer, menear, yacer, zorro, irse
he: once, irse, eso, orilla, ave
we: once, eso, ave, irse, oca
they: once, eso, notar, ayer, irse
what: once, eso, ayer, idea, meter
who: once, eso, oca, rico, asta
where: once, eso, vara, ayer, idea
where ... to: orilla, andar, toalla, allí, a causa de
how: once, eso, idea, ayer, no
why: once, eso, idea, ayer, no
how much: once, andar, muchacho, orilla, eso
one: once, oca, idea, pie, eso
two: no, eso, once, oca, idea
three: oca, eso, once, idea, no
four: eso, meter, once, ayer, oca
five: once, oca, eso, idea, pie
six: eso, once, ayer, meter, irse
seven: eso, once, ayer, tenedor, meter
eight: eso, once, ayer, meter, tenedor
nine: eso, once, pie, oca, irse
ten: tenedor, irse, ayer, eso, meter
eleven: irse, tenedor, ayer, llaga, eso
twelve: zorro, multicolor, irse, tenedor, llaga
twenty: eso, tenedor, ayer, meter, rey
thirty: zorro, ayer, sesenta, yacer, irse
forty: tenedor, bigote, tomar, ayer, maduro
fifty: fresco, fuego, foso, fino, frente
sixty: tenedor, noventa, sesenta, multicolor, eso
seventy: seis, señal, septiembre, seco, separarse
eighty: tenedor, noventa, sesenta, multicolor, muchacho
ninety: sesenta, irse, ayer, junio, zorro
a hundred: a solo, a veces, aún, a menudo, año
a thousand: a solo, a veces, aún, a menudo, año
and: andar, once, orilla, eso, oler
or: orilla, once, andar, eso, oler
stand: eso, ayer, meter, once, irse
sit: sitio, oler, ayer, irse, eso
hang: ayer, meter, eso, irse, once
become: once, noticia, muchacho, muchacha, eso
happen: hilo, haz, hambre, heno, hongo
begin: todo, idea, error, final, vara
change: idea, oca, meter, no, once
rise: oca, idea, irse, asta, ayer
set: seta, setenta, final, error, todo
shine: irse, ayer, oca, asta, raya
blow: blanco, revolver, fluir, hornear, llover
stream: meter, ayer, oca, idea, once
flow: meter, pie, eso, verter, ayer
revolve: revolver, tapadera, prometer, padres, menear
sway: prometer, zorro, revolver, oscuro, padres
swing: meter, ayer, eso, pie, revolver
fall: animal, oca, ayer, red, eso
burn: ayer, once, irse, eso, meter
freeze: pie, cola, meter, oca, idea
thaw: ayer, zorro, humear, jactarse, irse
melt: manta, morder, madera, mecer, mango
boil: rojo, bolso, robar, irse, pecho
rot: ayer, verter, meter, oler, irse
decay: meter, verter, ayer, animal, eso
snap: meter, ayer, oca, pie, irse
sink: meter, ayer, eso, pie, placer
pass: meter, ayer, once, eso, oca
appear: once, eso, meter, ayer, verter
disappear: discurso, disparar, disminuir, reptar, menear
decrease: de nuevo, dejar, decrecer, destruir, de repente
increase: idea, once, meter, no, eso
grow: once, ayer, eso, irse, meter
sparkle: revolver, tapadera, oscuro, ascender, tronco
be noisy: beber, once, muchacho, mentira, muchacha
chime: chico, chispa, chica, chispear, zorro
tinkle: tumba, taza, toser, tintinear, tapa
roar: robar, rojo, zorro, rogar, irse
rustle: revolver, tapadera, oscuro, bigote, muchacho
howl: muchacho, once, ayer, menear, eso
whistle: menear, zorro, irse, hornear, revolver
shout: jactarse, zorro, ganas, menear, ayer
groan: rojo, robar, irse, zorro, gancho
tremble: tintinear, toser, tumba, tía, taza
be alive: beber, once, muchacho, mentira, oveja
be born: beber, once, muchacha, muchacho, orilla
breathe: bello, brazo, barrer, bucear, bajo
drink: meter, ayer, oca, irse, pie
eat: ayer, irse, eso, oca, once
swallow: hornear, revolver, menear, zorro, ayer
get tired: quitarse, muchacho, once, sentarse, idea
fall asleep: muchacho, menear, bandada, sentarse, allí
wake up: muchacho, once, ayer, cueva, oveja
get up: once, sentarse, muchacho, meter, allí
relax: fluir, prometer, revolver, llover, pluma
fall ill: menear, muchacho, vestirse, sentarse, ayer
be ill: beber, once, muchacha, muchacho, ave
ache: irse, oca, bote, ayer, asta
cough: coger, cruz, cuna, cavar, cima
recover: once, meter, idea, eso, no
die: diez, pie, bote, gota, irse
perish: perca, percha, perro, perder, ayer
move: idea, meter, oca, once, pie
budge: bello, baya, bajo, bota, bajar
stand up: muchacho, bandada, sentarse, barca, menear
sit down: sitio, sentarse, ayer, muchacho, menear
tumble: tumba, taza, tío, tonto, tubo
pace: ayer, irse, oca, asta, eso
go for a walk: a menudo, orilla, muchacho, toalla, a solo
rush: ayer, irse, eso, meter, oca
hurry: hilo, hongo, hoy, hambre, hombre
dash: meter, ayer, oca, irse, asar
run: todo, meter, oca, irse, idea
jump: meter, ayer, oca, irse, once
climb: clase, clavo, fluir, zorro, revolver
seesaw: seis, separarse, irse, ensueño, poseer
creep: crecer, creer, prometer, ayer, revolver
swim: revolver, zorro, menear, padres, irse
dive: diente, dios, doler, dolor, diligente
drive: meter, idea, oca, pie, once
go: oca, oso, asta, todo, rico
go away: hielo, muchacho, oca, idea, rico
depart: ayer, irse, once, oca, eso
stop: no, quitarse, meter, once, eso
go in: toalla, idea, sentido, oca, asta
enter: meter, ayer, once, verter, irse
come: once, venir, ave, eso, ayer
arrive: arrancar, sentir, sentarse, declive, lleno
come back: once, sentarse, venir, allí, a menudo
stay: once, eso, irse, ayer, rey
wait: once, meter, ayer, eso, vara
wait for: once, sentarse, recordar, sentir, eso
seek: once, ayer, irse, eso, meter
look for: once, andar, muchacho, orilla, allí
find: once, idea, final, no, meter
try: once, eso, meter, ayer, error
prepare: oca, idea, meter, once, final
love: once, pie, oca, grave, ave
like: once, eso, ayer, idea, no
laugh: hermana, oca, gota, maestro, oveja
weep: ayer, once, oler, irse, verter
grumble: gritar, grasa, grano, gris, grulla
be annoyed: beber, once, muchacho, mentira, sentarse
be afraid: beber, once, muchacho, muchacha, orilla
be afraid of: orilla, a menudo, muchacho, once, beber
flee: foso, fresco, fregar, frente, fino
escape: meter, oca, idea, once, pie
see: once, eso, idea, oca, irse
look at: once, ayer, muchacho, sentarse, allí
watch: ayer, once, eso, irse, imagen
hear: once, ayer, irse, eso, dar
listen: abajo, once, meter, oca, ayer
taste: tapa, taza, tumba, tela, tubo
smell: humear, ayer, revolver, prometer, hurtar
feel: once, eso, ayer, irse, idea
seem: seis, separarse, seco, señal, irse
show: final, todo, meter, idea, oca
be cold: beber, once, muchacho, muchacha, orilla
do: doce, no, idea, eso, oca
can: once, eso, no, oler, idea
want: once, ayer, eso, idea, oca
start: todo, tabla, error, final, meter
finish: meter, idea, once, ayer, oca
succeed: sopa, sauce, silla, saber, sensato
turn out: sentarse, once, muchacho, sentir, vestirse
close: once, idea, oca, final, meter
put: once, ayer, meter, verter, eso
lay: ayer, eso, once, irse, rey
touch: meter, idea, eso, todo, oca
connect: idea, meter, oca, eso, asta
hang up: sentarse, batirse, vestirse, ayer, romper
pick up: ayer, sentarse, muchacho, romper, hornear
leave: once, oca, ayer, eso, idea
lose: once, ayer, eso, irse, meter
make: idea, oca, once, no, meter
produce: once, eso, idea, oca, meter
build: idea, todo, meter, oca, asta
mend: morder, mecer, madera, manta, muelle
improve: noticia, once, soporte, eso, sentido
alter: meter, verter, ayer, eso, once
dig: ayer, irse, meter, atar, oler
bend: bello, baya, bajo, bajar, bota
spin: meter, pie, cola, eso, sol
turn: meter, once, eso, ayer, verter
turn around: once, sentarse, muchacho, sentir, prometer
raise: final, once, no, vara, meter
lift: meter, ayer, idea, eso, asta
seize: seis, separarse, seco, irse, semana
hold: once, ayer, eso, meter, irse
press: irse, oca, ayer, meter, eso
push: todo, meter, final, tabla, pie
scrape: ascender, oscuro, oscilar, secarse, escoba
lick: ayer, irse, once, oler, meter
bite: pie, once, bote, ave, irse
tear off: techo, teñir, hornear, hurtar, barca
cut off: costado, multicolor, longitud, meter, sentarse
tie: pie, meter, asta, irse, oca
break: meter, once, eso, ayer, pie
knock: menear, hornear, hurtar, irse, zorro
hit: meter, ayer, eso, once, irse
glue: pieza, pie, pluma, cueva, multicolor
rub: ayer, irse, oler, pez, eso
spread: meter, ayer, once, eso, oca
grind: gritar, grano, grasa, gris, grande
cut: meter, ayer, pie, eso, multicolor
jolt: jefe, juntos, jactarse, joven, juego
shake: pie, oca, irse, ayer, asta
pour: venir, ayer, entre, once, eso
fill: meter, once, ayer, oca, verter
wrap: meter, idea, pie, oca, cola
carry: meter, ayer, once, eso, idea
drag: meter, ayer, pie, eso, oca
pull: meter, once, ayer, pie, oca
keep: once, eso, no, ayer, meter
throw: meter, once, eso, idea, pie
catch: once, ayer, meter, eso, oca
grab: ayer, meter, once, oca, irse
hide: oca, idea, meter, no, todo
divide: meter, once, oca, idea, pie
send: meter, once, no, eso, oca
bring: once, ayer, eso, irse, oca
add: final, todo, meter, no, idea
get: no, once, final, meter, idea
receive: once, oca, idea, no, eso
take: once, no, eso, oca, ave
choose: once, idea, oca, eso, meter
select: vara, eso, oca, idea, final
preserve: idea, oca, tabla, no, cola
hinder: hurtar, hongo, hilo, hambre, hombre
spoil: revolver, ayer, impeler, polvo, ganas
destroy: once, meter, ayer, eso, idea
give: once, eso, no, oca, ave
promise: idea, oca, todo, once, pie
praise: prado, pradera, pronto, principiar, irse
kiss: zorro, ganas, hurtar, jefe, juntos
rock: ayer, animal, meter, placer, red
wake: oca, irse, ayer, pie, asta
guide: oca, idea, meter, asta, irse
teach: techo, irse, teñir, ayuda, oveja
instruct: iniciar, invierno, sentido, oca, toalla
bring up: once, sentarse, muchacho, sentir, poseer
lead: meter, eso, animal, placer, idea
urge: once, oca, ayer, irse, ave
let: variar, vara, eso, final, onda
invite: oca, idea, once, todo, cola
unite: unir, un poco, irse, eso, reunirse
visit: ayer, oca, irse, once, eso
meet: ayer, once, eso, irse, rey
assemble: meter, idea, oca, ayer, irse
play: ayer, meter, irse, eso, once
sing: ayer, once, eso, irse, meter
dance: irse, oca, pie, arena, asta
separate: seis, seco, separarse, irse, semana
rescue: respirar, cueva, oca, aceite, resplandecer
guard: guardar, eso, ayer, meter, once
protect: once, oca, meter, eso, ayer
defend: defender, eso, animal, no, final
brawl: bello, bajar, bajo, baya, bota
shoot: ayer, once, eso, irse, meter
win: irse, meter, oca, eso, ayer
annoy: menear, irse, jactarse, humear, ayer
beat: ayer, meter, eso, irse, pie
kick: ayer, eso, meter, rey, irse
sting: menear, revolver, jactarse, jefe, zorro
shove: jactarse, menear, irse, hurtar, ayer
steal: irse, oca, asar, jefe, trazo
disturb: distinto, distancia, sentir, extremo, prometer
bother: robar, irse, menear, ayer, rojo
conceal: concebir, conseguir, conducir, congregarse, conmover
deceive: de nuevo, dejar, decrecer, destruir, de repente
cheat: cueva, irse, jefe, bigote, oveja
kill: eso, meter, ayer, once, irse
dwell: diente, doler, dolor, dios, dormir
gather: oca, ayer, meter, once, idea
pick: ayer, meter, eso, once, irse
hunt: ayer, irse, oca, eso, asta
herd: herida, hermana, hermano, hermoso, menear
tie up: vestirse, batirse, pie, cueva, barca
feed: meter, ayer, oca, pie, animal
chop: ayer, meter, irse, eso, oca
ripen: irse, lonja, menear, oler, oca
cook: ayer, irse, oca, eso, once
bake: bello, baya, bajo, bota, bajar
fry: fresco, fuego, foso, fregar, fino
stir: madurar, revolver, irse, sentir, menear
knit: menear, zorro, irse, ganas, madurar
sew: seis, seco, irse, semana, separarse
dye: diente, dios, dolor, doler, deseo
wash: ayer, meter, irse, once, eso
wipe: pie, meter, oca, idea, cola
rinse: tapadera, gancho, lonja, irse, madurar
sweep: sauce, sopa, saber, silla, sensato
bath: bello, baya, boca, bajo, bota
take off: once, sentarse, muchacho, sentido, toalla
put on: sentarse, sentir, sentido, once, prometer
get dressed: once, muchacho, idea, sentarse, ayer
decorate: idea, once, meter, ayer, oca
say: ayer, once, irse, asar, eso
speak: sauce, sopa, silla, saber, sensato
chat: meter, ayer, oca, todo, irse
ask: ayer, irse, eso, oca, once
request: todo, error, tabla, idea, oca
tell: once, eso, oca, ayer, idea
convey: conducir, conmover, concebir, conversación, conversar
brag: brillar, tragar, llover, barrer, lamer
translate: todo, oca, cola, tabla, idea
think: eso, idea, once, meter, ayer
believe: adelante, helada, ayer, irse, polvo
notice: once, idea, ayer, oca, meter
recognize: sentido, sentir, once, sentarse, mentira
grasp: gritar, grasa, grueso, grano, gris
understand: once, muchacho, allí, ayer, noticia
learn: idea, oca, eso, meter, ayer
know: once, ayer, eso, irse, meter
remember: once, ayer, eso, irse, oca
forget: once, ayer, eso, irse, no
measure: meter, once, eso, idea, ayer
calculate: correcto, meter, tabla, idea, no
read: idea, once, meter, ayer, eso
draw: meter, final, ayer, oca, once
write: idea, todo, once, oca, meter
own: eso, idea, once, oca, no
buy: ayer, asta, onda, idea, oca
sell: ayer, once, meter, eso, idea
pay for: eso, orilla, ayer, once, andar
pay: ayer, eso, meter, irse, once
rule: meter, idea, eso, once, ayer
endure: menear, muchacho, sentarse, sentir, poseer
