eye: iri, nine, boru, ada, ana
ear: dam, hat, cam, dar, ses
nose: nisan, narin, neden, nereye, tire
mouth: nine, dam, ok, hat, boru
tooth: toz, oraya, orada, on, at
tongue: tire, taze, tutamak, tuz, tutmak
lip: dam, cam, pus, ses, mart
cheek: cebir, yorgan, daire, gerdan, tepmek
face: nine, boru, iri, on, hat
forehead: dayak, yurt, oraya, nine, tire
hair: hat, nine, adam, ekim, ok
moustache: mavi, mide, millet, miktar, yorgan
beard: bez, oraya, yorgan, beş, turna
chin: yan, yen, boru, ekim, kan
jaw: boru, ak, dam, ekim, raf
throat: nine, boru, hat, cam, dam
neck: cam, nine, dam, boru, ak
nape: nisan, narin, nereye, neden, sene
head: cam, boru, usta, ad, nine
back: on, nine, at, ses, ok
spine: yara, kulp, tire, boru, kafa
belly: bel, gerdan, kayak, budak, baston
navel: dayak, taban, otlak, batmak, iplik
bosom: otlak, baston, bazan, dayak, gerdan
chest: cam, dam, raf, boru, ak
breast: cebir, yorgan, gerdan, tire, yurt
shoulder: oraya, toz, orada, dayak, on
arm: cam, dam, boru, mart, ak
elbow: elma, el, el ayası, daire, oraya
hand: cam, hat, adam, nine, ak
palm: pencere, pazar, pantolon, kulp, pahalı
finger: nine, boru, cam, ekim, yen
fingernail: fayda, fincan, onarmak, kayak, kederli
nail: nisan, narin, neden, tire, nereye
toe: toz, oraya, orada, boru, on
foot: cam, nine, hat, dam, boru
heel: cam, dam, hat, boru, adam
knee: keder, kafa, kulp, kent, kedi
thigh: yurt, tire, keder, dayak, otlak
leg: dam, cam, mart, ev, ak
body: boru, iri, cam, dam, usta
skin: boru, nine, ses, tin, cam
blood: nine, adam, raf, sol, ak
vein: ve, vefat etmek, cebir, boru, oraya
sinew: sinek, yorgan, bazan, sincap, sicim
bone: nine, boru, anne, hani, adam
brain: nine, cam, ekim, adam, ses
heart: nine, ekim, adam, hat, boru
stomach: gerdan, otlak, kayak, ovmak, baston
liver: lisan, tire, yorgan, batak, dilim
breath: artmak, yorgan, cebir, gerdan, mart
hunger: hata, hala, hasta, hemen, hoca
tear: tepe, tepmek, teyze, tekrar, cebir
flavour: iplik, dayak, yorgan, otlak, yurt
odour: otlak, ovmak, gerdan, ekim, yurt
sleep: nine, boru, fare, mart, ekim
dream: ekim, dam, ok, nine, adam
sky: ekim, boru, adam, usta, cam
sun: ekim, yen, boru, yan, ak
moon: ekim, nine, adam, yen, kim
star: dar, nine, boru, usta, kar
air: pak, cam, raf, boru, ak
wind: cam, dam, adam, ak, ekim
wave: nine, boru, iri, ata, ada
water: boru, nine, fare, dam, ses
stone: boru, nine, ada, adam, hani
soil: oraya, soğan, orada, boru, ok
ground: boru, nine, dam, fare, raf
earth: nine, ekim, adam, boru, raf
dust: dam, boru, cam, buz, pus
smoke: mide, yorgan, yurt, boru, tire
spark: boru, ekim, iri, cam, ip
fire: nine, raf, boru, adam, dam
light: nine, cam, boru, hat, dam
shadow: nine, ekim, adam, raf, cam
weather: usta, boru, adam, ekim, nine
fog: fincan, fayda, batak, duman, kulp
cloud: ad, biz, ip, usta, ekim
rain: dam, boru, ekim, nine, cam
snow: nine, at, orman, adam, ekim
ice: nine, boru, usta, iri, adam
frost: fayda, fincan, batak, kulp, kent
chill: kent, kulp, akmak, kral, yorgan
heat: sol, bit, boru, nine, fare
hoarfrost: fayda, kederli, yaka, yorgan, kafa
rainbow: dayak, kayak, topuk, koru, onarmak
thunder: kent, otlak, kasket, yurt, yorgan
current: on, nine, usta, ata, iri
drop: dam, on, boru, ses, hat
foam: boru, boya, yara, iri, torba
dirt: dilim, duman, dert, dolu, diz
lake: anne, adam, kim, kara, orman
swamp: dayak, otlak, ekim, kayak, yurt
moor: boru, yaka, torba, koru, elma
meadow: oraya, yurt, damla, gerdan, dayak
forest: raf, dayak, usta, ekim, nine
hill: adam, ekim, kim, cam, raf
elevation: yara, iri, boru, usta, yaka
mountain: dayak, kayak, adam, yurt, turna
summit: dayak, otlak, topuk, turna, sicim
cave: cuma, cereyan, cilt, cimri, batak
slope: nine, boru, usta, fare, ada
source: bin, on, ip, abi, iri
brook: kim, adam, ekim, ben, buz
river: dayak, boru, ekim, dam, nine
shore: fare, nine, boru, usta, raf
coast: cebir, usta, oraya, yurt, kafa
land: dam, fare, ak, raf, mart
sea: kova, ana, ada, usta, kara
cove: cuma, cereyan, cilt, cimri, kafa
island: isim, oraya, isabet etmek, orada, dayak
flower: nine, ekim, adam, birden, boru
grass: adam, nine, boru, ekim, cam
root: bin, boru, ip, abi, iri
tree: nine, boru, iri, ada, usta
trunk: ovmak, otlak, kasket, kulp, tire
bark: batak, bayan, baba, bellek, bilmek
limb: batak, serin, yorgan, dilim, boru
branch: boru, usta, iri, nine, ses
leaf: nine, boru, cam, ekim, raf
birch: bir, biraz, on bir, bir defa, birinci
pine: nine, anne, boru, ada, adam
willow: oraya, orada, onarmak, toz, bazan
fir: bir, boru, ekim, ak, kaz
horn: dam, boru, cam, buz, ekim
feather: cebir, yara, torba, boru, koru
fur: boru, hat, ak, dam, ekim
wing: ekim, boru, cam, dam, hat
claw: ovmak, kasket, tire, otlak, kayak
tail: cam, boru, sol, nine, dam
egg: boru, adam, ekim, nine, millet
nest: mart, ses, boru, usta, cam
lair: lisan, yorgan, dilim, kulp, batak
animal: nine, raf, boru, birden, ekim
flock: fincan, fayda, batak, kasket, kulp
cow: dam, cam, buz, ekim, adam
bull: buz, boru, dam, ekim, raf
horse: nine, birden, usta, boru, raf
sheep: boyamak, oraya, heves, bazan, hekim
pig: dam, cam, boru, ses, ak
dog: adam, ekim, nine, birden, raf
cat: hat, tat, cam, ot, ses
bear: adam, ekim, boru, raf, dam
squirrel: sopa, sandal, soba, sene, sabit
elk: elma, el, kent, kuyu, kayak
fox: ekim, adam, raf, usta, ak
hare: fare, ekim, ses, boru, buz
mouse: nine, ata, boru, cam, on
wolf: raf, adam, ekim, boru, ben
bird: birden, ekim, adam, nine, raf
swarm: otlak, ovmak, onarmak, yurt, yorgan
chicken: millet, batak, kent, keder, kayak
cock: cam, ekim, mart, dam, ak
goose: turna, torba, oraya, yara, yaka
eagle: usta, boru, yara, iri, yaka
duck: ekim, adam, buz, dam, kim
owl: ekim, adam, raf, boru, nine
crane: yurt, cebir, torba, yorgan, boru
crow: ekim, mart, adam, cam, dam
cuckoo: cereyan, cuma, kafa, kulp, kayak
swan: bazan, kayak, yorgan, kent, gerdan
fish: ekim, boru, dam, ses, nine
perch: otlak, gerdan, torba, dayak, yurt
pike: iri, ekim, abi, ata, boru
snake: nine, boru, iri, adam, ekim
worm: cam, boru, dam, ekim, buz
spider: kulp, yurt, tire, kasket, batmak
ant: mart, ot, ak, ev, dam
louse: lisan, yorgan, batak, yurt, sandal
midge: mide, mavi, millet, miktar, mektup
fly: buz, ekim, cam, dam, adam
butterfly: batak, bellek, bayan, baba, bilemek
berry: adam, ekim, kim, boru, nine
apple: boru, usta, adam, iri, ada
mushroom: millet, mavi, miktar, mide, kayak
onion: on, onarmak, on iki, on bir, onlar
seed: ses, boru, nine, ak, ad
grain: tire, gerdan, keder, ak, cebir
hay: hayat, hayvan, ay, ekim, hat
husk: husus, pus, otlak, baston, gerdan
pit: dam, boru, pus, ak, buz
trap: ot, dam, boru, on, mart
noose: oraya, turna, orada, toz, torba
track: boru, usta, cam, nine, dam
ashes: boru, ekim, ses, usta, dam
filth: otlak, gerdan, fakir, artmak, bazan
iron: tin, boru, raf, nine, sol
gold: boru, adam, nine, raf, kim
silver: nine, adam, boru, kim, raf
coal: boru, sol, mal, sandık, dal
glass: boru, nine, cam, ekim, adam
clay: kent, kayak, bazan, keder, akmak
sand: sandık, ak, boru, cam, dam
human: on, nine, boru, ses, orman
man: son, yan, sen, mart, ben
woman: usta, orman, adam, nine, ben
child: usta, nine, son, adam, ekim
boy: boyamak, boyun, adam, ekim, dam
girl: boyamak, boyun, adam, ekim, kim
family: nine, usta, dayak, adam, orman
grandfather: dayak, oraya, adam, gayet, bazan
grandmother: dayak, gayet, oraya, boyamak, adam
parents: usta, ses, nine, boru, sopa
father: adam, orman, don, ekim, son
mother: adam, ekim, kim, orman, nine
son: son, sonra, sonradan, sen, don
daughter: son, oraya, orman, ekim, boru
brother: heykel, gerdan, adam, donmak, bazan
sister: sopa, sene, sandal, soba, sabit
uncle: kent, adam, kayak, donmak, dayak
aunt: aile, oraya, yaka, daire, kafa
husband: husus, boyamak, son, otlak, oraya
wife: hani, boru, usta, oraya, nine
joy: adam, ekim, kim, don, ben
laughter: nine, ekim, orman, hat, adam
happiness: hata, hala, hasta, hissetmek, hemen
grief: guguk, gelmek, girmek, güz, gazete
wish: ok, hat, ekim, dam, mart
desire: ses, oraya, esmek, daire, cebir
spirit: ekim, nine, dayak, adam, mart
thought: hat, ok, on, mart, ot
memory: nine, boru, usta, abi, iri
mind: hat, dam, ekim, mart, buz
meaning: on, hat, had, ok, ses
reason: on, ses, son, hat, had
truth: ekim, mart, hat, ok, dam
talk: biz, ekim, ok, iri, buz
fairy tale: fayda, yurt, batak, bellek, yarmak
story: nine, ekim, usta, ok, hat
message: ip, bin, iri, on, abi
news: iri, usta, nine, abi, boru
name: ip, bin, iri, boru, abi
puzzle: pazar, pencere, sopa, pantolon, kulp
speech: nine, usta, ad, ses, on
language: iri, nine, usta, abi, boru
voice: nine, usta, iri, boru, ada
word: bit, ip, cam, ot, bin
sign: on, son, ses, mart, ev
call: on, ok, ip, ot, at
noise: nine, boru, iri, usta, ada
sound: bit, nine, cam, dam, boru
tone: nine, boru, ses, iri, fare
song: son, hat, ekim, ok, yen
calm: dayak, oraya, onarmak, yorgan, yurt
people: usta, nine, boru, ekim, on
nation: usta, ekim, nine, dam, ses
work: fare, it, usta, on, boru
guest: usta, ekim, adam, nine, iri
gift: mart, hat, usta, boru, ekim
game: iri, abi, usta, nine, boru
company: usta, boru, iri, nine, ata
help: on, usta, ok, at, ot
friend: son, ot, ok, mart, hat
companion: itmek, torba, yara, cebir, ekim
matter: hat, ses, dam, nine, fare
count: ot, on, mart, ses, siz
sort: ot, ses, on, siz, mart
piece: boru, nine, iri, ses, hat
part: mart, ot, ses, ad, son
half: nine, raf, adam, kim, ak
circle: nine, boru, iri, usta, cam
cross: nine, cam, usta, adam, ak
line: boru, nine, iri, bin, ata
stroke: nine, usta, iri, ada, boru
gap: boru, usta, ekim, cam, ak
distance: nine, boru, iri, usta, fare
area: usta, boru, ada, iri, kova
space: nine, boru, iri, usta, raf
place: on, boru, nine, iri, ses
side: nine, boru, iri, usta, ada
middle: nine, adam, boru, usta, raf
item: iri, boru, ot, ekim, ip
thing: hat, ok, ot, mart, dam
fringe: yurt, yorgan, yaka, kafa, cebir
edge: boru, nine, iri, ada, usta
corner: nine, usta, adam, ada, boru
tip: ip, cam, ot, ses, boru
end: ot, on, ev, ses, hat
hole: boru, nine, dam, hat, fare
angle: boru, abi, nine, bit, iri
pattern: boru, iri, nine, bin, bit
size: boru, nine, siz, iri, bin
length: boru, siz, on, nine, ot
height: boru, siz, bit, bin, ot
weight: boru, nine, dam, fare, ot
amount: boru, on, ses, nine, ot
heap: ip, boru, bin, bit, abi
row: cam, dam, ses, dayak, boru
boat: boru, yurt, dayak, raf, usta
oar: o, oraya, orada, boru, yaka
sleigh: sandal, sopa, soba, sene, sarsmak
ski: iri, elli, usta, boru, hani
campfire: dayak, kayak, topuk, yurt, gayet
load: on, bin, ip, post, bit
walk: mart, ok, dam, ekim, buz
step: cam, boru, dam, ses, ot
north: adam, kim, ekim, ben, raf
south: adam, kim, ekim, raf, ben
west: adam, kim, ekim, ben, usta
east: adam, ekim, kim, ben, raf
wood: boru, cam, adam, ekim, nine
board: usta, boru, bin, abi, iri
slab: yurt, keder, tire, otlak, kayak
bracket: otlak, yurt, yorgan, tire, onarmak
pole: boru, fare, nine, cam, ile
stick: cam, boru, bit, dam, ak
staff: usta, raf, ekim, boru, nine
pipe: boru, nine, tire, ada, cam
house: nine, usta, boru, raf, dam
home: usta, nine, in, iri, boru
stove: tire, yurt, keder, kayak, adam
floor: boru, nine, ada, tire, usta
table: abi, boru, bit, bin, ip
chair: nine, hat, yurt, boru, usta
cradle: batak, cebir, keder, yurt, duman
bed: cam, dam, hat, buz, boru
shelf: nine, boru, cam, dam, usta
box: boru, cam, dam, nine, bin
window: iri, bit, abi, boru, usta
door: boru, hat, cam, nine, adam
gate: boru, nine, iri, ata, ada
fence: fayda, fincan, yurt, keder, tire
roof: tire, boru, usta, dam, cam
ladder: lisan, yurt, keder, tire, batak
broom: batak, bayan, baba, bellek, bilmek
spade: yara, yaka, boru, kulp, torba
shovel: kayak, otlak, kasket, kulp, yurt
fork: boru, dam, ok, cam, ak
spoon: kulp, kasket, otlak, yurt, yorgan
knife: boru, nine, iri, usta, ada
net: bit, ip, biz, ot, ak
hook: ip, abi, bit, post, boru
handle: on, ip, boru, ot, ata
lock: on, hat, ok, boru, at
picture: on, nine, hat, boru, ekim
figure: boru, iri, usta, nine, ses
doll: dam, ekim, hat, boru, mart
pouch: pencere, pantolon, pazar, kulp, pahalı
bundle: bin, ip, abi, bit, boru
bag: dam, hat, boru, siz, cam
bucket: boru, nine, dam, cam, hat
cover: on, nine, hat, at, ekim
dishes: dilim, duman, dert, dolu, diz
sack: sandal, sopa, soba, sene, sincap
cup: dam, boru, cam, ses, mart
pot: ot, pus, cam, hat, ses
kettle: keder, kent, kasket, kuyu, kulp
meal: fare, boru, sol, nine, iri
food: nine, fare, usta, ad, ok
dish: boru, dam, ekim, ok, ses
meat: millet, oraya, yurt, taze, soba
corn: millet, cam, ses, boru, ben
mush: mavi, mide, millet, miktar, mektup
bread: adam, boru, ekim, millet, nine
slice: boru, iri, nine, ada, bin
fat: tat, hat, ak, dam, ok
butter: batak, bayan, baba, bilmek, bellek
oil: boru, sol, nine, dam, adam
salt: boru, tin, sol, iri, mart
soup: ekim, boru, hani, nine, adam
honey: hala, hata, hemen, hasta, hava
milk: millet, mavi, mide, miktar, mektup
tea: boru, kova, iri, usta, ada
leather: lezzet, aile, baston, yurt, daire
wool: torba, yurt, yarmak, boru, yorgan
cloth: boru, nine, cam, dam, hat
needle: nine, boru, tire, cam, adam
thread: boru, bit, ip, iri, cam
button: boru, iri, usta, ekim, nine
knot: kasket, kulp, keder, kent, kilit
paint: boru, dam, hat, cam, ok
clothes: yurt, koru, torba, tire, keder
shirt: hat, boru, nine, ekim, usta
collar: oraya, yurt, torba, baston, yorgan
sleeve: sandal, sene, sopa, soba, sincap
trousers: onarmak, otlak, yollamak, sallamak, yurt
belt: boru, dam, raf, tire, usta
cap: cam, dam, ak, ev, mart
shoe: tire, yurt, keder, sandal, kederli
boot: cam, boru, ot, mart, ekim
ring: boru, cam, hat, nine, ses
ribbon: boru, iri, nine, ekim, usta
comb: boru, dam, cam, sol, ev
mirror: boru, nine, ekim, cam, torba
strap: dam, cam, boru, hat, ekim
string: bin, ip, on, ot, ses
leash: lezzet, yorgan, otlak, aile, cebir
blanket: topuk, dayak, yurt, onarmak, oraya
pillow: dayak, yurt, tire, baston, turna
scarf: oraya, koru, yurt, artmak, torba
towel: tire, taze, tuz, tane, tutamak
force: boru, on, nine, ata, fare
strength: on, boru, dam, hat, ses
health: usta, nine, ekim, ak, ses
illness: oraya, ses, toz, artmak, orada
pain: dam, ses, hat, nine, son
wound: yurt, tire, keder, batak, kulp
fever: cebir, yorgan, torba, gerdan, yurt
medicine: nine, usta, boru, iri, ada
bridge: boru, usta, ada, nine, iri
well: ok, had, hat, dam, mal
pasture: dayak, artmak, nine, oraya, yurt
path: bin, ip, bit, abi, ot
way: ay, ok, hat, ot, dam
road: dam, usta, nine, raf, adam
village: vurmak, kafa, yurt, batak, boru
town: usta, dayak, ekim, boru, dam
letter: nine, hat, boru, usta, ot
book: ekim, nine, on, hat, iri
character: nine, boru, hat, on, iri
newspaper: onarmak, topuk, artmak, otlak, oraya
life: nine, usta, iri, boru, ana
death: nine, adam, dayak, dam, hat
grave: nine, boru, dam, anne, iri
church: usta, nine, ekim, raf, adam
sin: sen, yan, bin, tin, boru
god: ekim, adam, ok, buz, son
worker: usta, abi, iri, boru, bin
boss: ekim, boru, usta, adam, buz
master: boru, ekim, usta, adam, nine
doctor: adam, usta, ekim, ben, boru
teacher: usta, nine, adam, ekim, boru
money: nine, usta, fare, boru, yen
business: usta, biz, nine, boru, iri
shop: ekim, boru, iri, usta, nine
price: boru, nine, ada, usta, fare
ware: fare, boru, ses, mart, dam
profit: fare, hat, yen, ot, dam
wealth: ekim, nine, dam, fare, ak
world: pak, usta, nine, ekim, boru
country: dayak, nine, usta, adam, boru
state: usta, nine, boru, abi, iri
king: adam, kim, ekim, ben, don
power: nine, fare, boru, usta, ata
border: nine, boru, usta, on, raf
war: dar, kar, raf, dam, hat
enemy: nine, raf, boru, iri, usta
violence: oraya, cebir, toz, mart, artmak
fight: dam, on, hat, ok, nine
bow: cam, dam, boru, buz, ekim
arrow: usta, nine, boru, on, iri
gun: raf, dam, ak, cam, buz
mistake: otlak, oraya, onarmak, dayak, toz
lie: ne, nine, ve, ses, ense
damage: boru, nine, on, dam, iri
misfortune: misafir, oraya, otlak, cebir, pislik
fault: nine, on, boru, dam, ses
age: nine, ve, ses, usta, boru
conclusion: cebir, ses, boru, oraya, aile
time: nine, fare, iri, usta, boru
day: dayak, dayı, ay, dayanmak, dam
morning: dayak, koru, oraya, horoz, artmak
noon: boru, ekim, iri, usta, mart
evening: dayak, oraya, nine, orada, toz
night: dayak, nine, adam, raf, cam
week: dayak, usta, nine, ok, ses
month: dayak, nine, usta, on, ot
year: dayak, nine, usta, yen, ses
spring: ekim, usta, boru, nine, ada
summer: nine, usta, dayak, adam, ekim
autumn: dayak, artmak, otlak, gerdan, oraya
winter: nine, dayak, adam, usta, ekim
January: orman, in, at, nine, usta
February: orman, in, at, nine, usta
March: orman, at, in, nine, usta
April: orman, in, at, nine, adam
May: mayıs, ay, at, orman, had
June: orman, at, nine, in, ata
July: orman, in, at, nine, usta
August: orman, at, in, nine, ata
September: orman, in, at, nine, usta
October: orman, in, at, nine, usta
November: orman, in, at, nine, usta
December: orman, in, at, nine, usta
Monday: orman, at, in, nine, on
Tuesday: orman, at, nine, in, on
Wednesday: orman, at, nine, in, on
Thursday: orman, at, nine, in, on
Friday: orman, in, nine, at, fare
Saturday: orman, at, nine, in, usta
Sunday: orman, in, at, nine, iyi
big: adam, nine, ok, pak, dam
little: nine, adam, orman, ekim, kim
long: nine, adam, kim, cam, hat
short: nine, on, adam, boru, hat
wide: nine, boru, ada, on, usta
narrow: narin, nisan, neden, nereye, yurt
dense: nine, boru, ses, sol, bit
thick: yurt, yorgan, keder, otlak, kent
thin: boru, tin, nine, on, in
delicate: delik, elma, oraya, daire, orada
firm: boru, mart, dam, ses, son
flat: nine, boru, hat, cam, dam
smooth: nine, on, cam, boru, adam
hard: nine, ok, cam, dam, ak
soft: nine, cam, mart, boru, ekim
round: nine, boru, turna, adam, cam
pointed: turna, oraya, dayak, nine, orada
sharp: boru, raf, nine, usta, ekim
blunt: otlak, kulp, tire, mart, kent
heavy: nine, boru, adam, dam, on
beautiful: nine, ok, oraya, on, at
hot: boru, ok, pak, ot, nine
warm: ok, dam, nine, adam, kim
cold: adam, nine, kim, ok, cam
cool: ok, nine, topuk, adam, pak
fresh: nine, ok, ekim, adam, pak
damp: dilim, dert, duman, dolu, diz
wet: keder, kent, yurt, batak, tire
dry: boru, dam, ok, cam, nine
full: nine, on, boru, usta, adam
empty: nine, on, boru, iri, abi
open: on, in, at, ip, nine
closed: on, nine, at, in, orman
clean: boru, on, nine, ada, ok
dirty: adam, nine, ekim, kim, ok
raw: ses, ekim, boru, ak, pak
ripe: nine, boru, usta, iri, ada
delicious: delik, elma, oraya, daire, heykel
sweet: adam, ekim, ok, kim, don
bitter: batak, bayan, baba, bellek, bilmek
sour: sandal, soba, sopa, sene, sabit
bright: nine, ekim, adam, mart, kim
dark: nine, ekim, adam, kim, ok
black: nine, adam, kim, raf, pak
white: nine, ada, boru, anne, adam
red: adam, ben, ekim, kim, pak
yellow: nine, adam, ekim, boru, kim
blue: nine, boru, adam, ekim, usta
green: nine, boru, ben, ekim, usta
grey: adam, nine, kim, boru, ekim
colourful: dayak, turna, nine, topuk, koru
cheap: topuk, at, nine, on, boru
dear: daire, heykel, oraya, elma, orada
precious: ancak, oraya, dayak, otlak, cereyan
blind: nine, on, dam, raf, ok
deaf: daire, gayet, orman, dede, cebir
powerful: nine, turna, oraya, topuk, on
strong: on, nine, at, ses, boru
weak: on, nine, ses, ak, sol
slim: kent, kayak, dilim, keder, otlak
pretty: nine, ok, adam, ekim, dam
evil: ekim, nine, adam, ok, ak
stupid: kent, yorgan, otlak, yay, ok
lazy: nine, bit, adam, cam, iri
diligent: dilim, dert, duman, dalmak, dudak
stingy: kayak, onarmak, dayak, otlak, yarmak
clever: gerdan, cebir, oraya, yorgan, otlak
skilful: onarmak, otlak, kayak, akmak, ovmak
merry: mavi, millet, mide, miktar, batak
gentle: oraya, gerdan, yorgan, onarmak, dayak
hungry: dayak, heykel, kim, gayet, boyamak
sick: sopa, sandal, sene, soba, sallamak
naked: nisan, narin, neden, yurt, yorgan
sad: ok, dam, ay, ad, ot
living: nine, on, ekim, adam, ses
good: ok, on, nine, had, dam
bad: ok, ak, raf, dam, hat
correct: on, ses, nine, boru, ot
nasty: nisan, narin, neden, nereye, yorgan
true: nine, on, boru, ok, usta
old: nine, adam, ok, ekim, raf
new: on, nine, at, ok, in
former: at, on, orman, in, nine
aged: nine, had, ok, ses, ay
young: nine, adam, kim, ekim, gayet
poor: oraya, daire, aile, boru, toz
rich: ekim, adam, kim, ben, don
familiar: fayda, fincan, batak, yorgan, toz
famous: fayda, fincan, batak, kent, kafa
foreign: nine, usta, raf, pak, boru
different: on, nine, had, at, hat
near: at, on, orman, in, ince
far: dar, kar, ak, mal, iz
left: on, nine, ot, ok, mart
right: ok, on, nine, ot, hat
other: on, nine, at, in, ses
first: on, nine, ok, usta, boru
second: nine, on, at, usta, raf
third: nine, on, at, usta, raf
last: nine, on, ok, usta, dayak
alone: nine, boru, on, oraya, hat
at once: at, atmak, orada, oraya, atlamak
together: toz, oraya, orada, on, onarmak
suddenly: sopa, sandal, sene, soba, sallamak
instantly: oraya, orada, turna, nine, toz
later: had, on, ince, hat, son
now: ok, on, had, hat, it
today: ok, on, hat, ekim, usta
tomorrow: adam, kim, donmak, ekim, heykel
soon: had, ok, son, hat, on
then: had, on, ince, orada, toz
yesterday: yay, yorgan, yaka, yurt, yedi
once: had, ince, on, nine, hat
at that time: at, atmak, orada, oraya, atlamak
afterwards: oraya, orada, on, had, toz
before: on, ince, at, ok, post
at first: at, atmak, orada, oraya, atlamak
sometimes: had, on, ince, ok, hat
often: had, on, hat, orada, it
always: had, ok, on, it, hat
never: had, ok, it, don, hat
here: ok, on, boru, hat, nine
hither: hata, hala, hemen, hissetmek, hasta
hence: hata, hasta, hala, hemen, hissetmek
there: it, nine, dere, ve, ne
thither: yahut, otlak, yorgan, oraya, onarmak
ahead: boru, on, nine, ok, usta
forward: on, nine, fare, usta, boru
backward: usta, o, on, iri, at
below: on, at, had, boru, hat
down: on, ok, dam, nine, boru
above: on, nine, at, boru, ses
up: ok, ip, on, dam, ot
everywhere: oraya, orada, on, nine, onarmak
not: had, on, ot, ok, at
a little: aile, oraya, orada, on, yaka
hardly: oraya, had, ok, nine, dayak
very: had, ok, on, ay, hat
so: soğan, ok, had, ince, on
still: ok, hat, had, on, it
only: had, on, hat, ok, at
already: had, on, it, ok, hat
again: had, ok, on, hat, son
in vain: in, inmek, inlemek, orada, oraya
in front of: inmek, in, orada, oraya, at
behind: yahut, oraya, onarmak, toz, otlak
under: at, on, in, nine, ince
through: on, at, had, ince, in
next to: at, oraya, on, orada, toz
between: on, at, ince, in, had
because of: on, ince, had, orada, oraya
this: on, boru, hat, ok, nine
that: had, on, hat, ince, at
everything: ok, hat, nine, it, on
I: had, ve, orman, iz, ne
you: had, ok, it, son, hat
thou: yorgan, yahut, otlak, hissetmek, yurt
he: heves, hekim, hepsi, had, ince
we: ve, ne, had, it, boru
they: had, it, hat, son, toz
what: hat, on, had, ok, ince
who: had, it, usta, boru, son
where: on, ince, had, at, nine
where ... to: orada, oraya, toz, atmak, on iki
how: on, had, ince, ok, at
why: on, ince, at, ok, had
how much: oraya, orada, had, on, ince
one: nine, ne, boru, usta, iri
two: nine, on, boru, usta, oraya
three: nine, usta, on, boru, iri
four: nine, on, at, ses, adam
five: nine, usta, on, boru, at
six: nine, at, on, ses, ekim
seven: nine, on, at, orman, ses
eight: nine, at, on, ses, orman
nine: nine, usta, boru, ekim, orman
ten: nine, sen, ses, on, ekim
eleven: nine, yorgan, oraya, aile, ekim
twelve: nine, oraya, yorgan, yurt, onarmak
twenty: nine, adam, ekim, usta, at
thirty: nine, yurt, yorgan, yedi, ekim
forty: nine, adam, kim, orman, dayak
fifty: fayda, nine, fincan, farklı, batak
sixty: nine, topuk, oraya, dayak, yurt
seventy: seksen, sebep, sevmek, yorgan, sevinç
eighty: nine, oraya, topuk, yurt, on iki
ninety: nine, yorgan, ekim, oraya, yurt
a hundred: aile, nine, oraya, orada, on iki
a thousand: aile, nine, oraya, orada, yaka
and: had, on, orada, at, ince
or: orada, oraya, had, on, at
stand: hat, dam, mart, ok, boru
sit: ot, siz, tat, hat, son
hang: hat, dam, ok, buz, kim
become: oraya, orada, toz, yorgan, had
happen: hata, hasta, hala, hemen, hissetmek
begin: on, bin, ot, fare, abi
change: on, boru, nine, turna, iri
rise: boru, nine, usta, iri, yen
set: ip, bin, bit, ad, ev
shine: nine, boru, ekim, hani, iri
blow: otlak, kasket, yurt, batak, dayak
stream: on, at, boru, nine, ot
flow: boru, cam, ses, nine, fare
revolve: otlak, torba, turna, dayak, iplik
sway: otlak, ovmak, kasket, onarmak, yorgan
swing: cam, boru, nine, adam, ekim
fall: usta, nine, dayak, raf, dam
burn: dam, boru, mart, ok, buz
freeze: boru, nine, iri, ada, usta
thaw: otlak, yorgan, onarmak, ovmak, yahut
melt: mide, millet, mavi, miktar, mektup
boil: boz, boya, bozmak, boynuz, boğa
rot: ot, mart, ev, cam, sen
decay: nine, ses, boru, dam, hat
snap: cam, ekim, dam, boru, pak
sink: boru, dam, ok, cam, ak
pass: ses, ot, mart, dam, ok
appear: had, on, ses, ok, mart
disappear: ses, otlak, pislik, yorgan, turna
decrease: daire, orada, oraya, mide, aile
increase: on, boru, ses, nine, at
grow: nine, ok, dam, ekim, ses
sparkle: dayak, torba, turna, iplik, arka
be noisy: bez, oraya, orada, had, toz
chime: yorgan, otlak, kafa, cebir, kulp
tinkle: taze, tire, tuz, tane, tutamak
roar: yorgan, gerdan, oraya, cebir, otlak
rustle: torba, turna, bazan, onarmak, otlak
howl: oraya, onarmak, toz, boru, turna
whistle: yorgan, otlak, gerdan, kulp, kayak
shout: yahut, otlak, kulp, kasket, yorgan
groan: gerdan, yorgan, bazan, torba, boru
tremble: taze, tutamak, tire, tuz, tutmak
be alive: bez, oraya, orada, beş, nine
be born: bez, beş, oraya, orada, had
breathe: batak, bayan, bellek, baba, bilemek
drink: nine, ok, ekim, dam, ses
eat: tat, ekim, nine, ok, adam
swallow: onarmak, otlak, kayak, ovmak, dayak
get tired: getirmek, turna, on, ok, oraya
fall asleep: dayak, turna, oraya, nine, yurt
wake up: oraya, turna, dayak, heykel, orada
get up: getirmek, ok, on, turna, oraya
relax: otlak, ovmak, yorgan, yurt, iplik
fall ill: dayak, oraya, yurt, turna, artmak
be ill: bez, beş, had, ne, ve
ache: boru, ses, ne, iri, mart
cough: cilt, cuma, cereyan, cimri, batak
recover: on, ok, nine, boru, had
die: nine, boru, hat, ne, deri
perish: otlak, gerdan, oraya, ses, onarmak
move: nine, on, boru, turna, iri
budge: batak, bayan, baba, bellek, bilmek
stand up: turna, oraya, yurt, orada, dayak
sit down: oraya, ok, yahut, yurt, heykel
tumble: tire, taze, tane, tuz, tutamak
pace: usta, boru, nine, ekim, iri
go for a walk: oraya, orada, onarmak, on iki, ayna
rush: ekim, buz, adam, raf, ak
hurry: hata, hala, hasta, hissetmek, hemen
dash: boru, ekim, cam, ak, dam
run: bin, on, ok, ot, ip
jump: dam, mart, boru, cam, ot
climb: kayak, otlak, batak, yurt, kulp
seesaw: onarmak, cebir, oraya, yorgan, otlak
creep: otlak, gerdan, ovmak, cebir, baston
swim: kayak, artmak, yurt, otlak, dayak
dive: duman, dilim, dolu, dert, diz
drive: nine, boru, usta, ata, iri
go: iri, boru, usta, ada, nine
go away: oraya, orada, turna, yaka, boru
depart: mart, ses, on, ot, boru
stop: on, dam, ok, ot, boru
go in: oraya, orada, turna, toz, boru
enter: on, ot, ses, boru, at
come: ense, fare, boru, ince, son
arrive: otlak, boru, turna, dayak, cebir
come back: oraya, orada, heykel, ayna, yahut
stay: nine, ay, ok, adam, ekim
wait: ok, ot, hat, dam, on
wait for: on, ok, oraya, orada, yay
seek: on, ses, ok, mart, dam
look for: oraya, orada, on, had, ok
find: on, at, nine, ses, ok
try: on, ok, at, ot, ses
prepare: on, boru, ses, nine, usta
love: nine, boru, usta, iri, ok
like: on, ince, had, at, ok
laugh: daire, aile, turna, elma, ayna
weep: dam, mart, boru, ok, buz
grumble: gerdan, kasket, ekim, otlak, ovmak
be annoyed: bez, oraya, orada, had, beş
be afraid: bez, oraya, orada, beş, nine
be afraid of: oraya, orada, bez, on iki, isabet etmek
flee: fayda, fincan, taze, sene, sopa
escape: nine, boru, on, iri, ses
see: on, at, orada, oraya, ince
look at: oraya, on, orada, ok, yay
watch: at, on, nine, ok, ekim
hear: on, dar, hat, ok, don
listen: ok, on, nine, iri, yen
taste: taze, tire, tane, tuz, tutamak
smell: yorgan, otlak, onarmak, ovmak, yurt
feel: had, ok, on, hat, dam
seem: seksen, sevmek, sebep, yorgan, ses
show: on, post, nine, ip, usta
be cold: bez, beş, oraya, orada, had
do: doğu, on, boru, o, nine
can: canlı, on, had, ince, toz
want: had, ok, on, ot, mart
start: on, post, ip, bit, ot
finish: boru, on, ok, dam, nine
succeed: sopa, sene, sandal, soba, sincap
turn out: turna, turnabalığı, oraya, orada, onarmak
close: on, at, nine, ok, in
put: on, had, ot, ok, ses
lay: ay, hat, dam, buz, ok
touch: bit, on, ok, nine, boru
connect: on, iri, usta, boru, abi
hang up: turna, batmak, onarmak, yahut, yurt
pick up: oraya, onarmak, orada, turna, on
leave: on, nine, boru, usta, at
lose: on, nine, ses, had, boru
make: on, nine, boru, ada, iri
produce: on, nine, ses, boru, had
build: bin, abi, boru, ada, iri
mend: mide, mavi, millet, miktar, dilim
improve: imaj, isim, oraya, on, sicim
alter: on, dam, ses, ev, ot
dig: mart, dam, ot, ak, ekim
bend: batak, bayan, baba, bellek, bilmek
spin: bin, sol, boru, tin, cam
turn: turna, on, hat, dam, turnabalığı
turn around: turna, turnabalığı, oraya, orada, onarmak
raise: on, nine, ses, boru, ot
lift: boru, cam, fare, dam, usta
seize: seksen, sebep, cebir, sevmek, ense
hold: on, had, hat, ok, dam
press: ses, usta, mart, boru, ekim
push: ip, post, pus, on, bin
scrape: yara, sopa, abi, iri, usta
lick: ok, ekim, dam, buz, mart
bite: nine, boru, iri, usta, fare
tear off: tepe, tepmek, teyze, oraya, orada
cut off: turna, oraya, onarmak, orada, dayak
tie: boru, nine, iri, hani, usta
break: on, ok, boru, ses, nine
knock: kent, kulp, otlak, yorgan, kasket
hit: hat, ot, ok, ak, dam
glue: boru, yara, tire, torba, uyluk
rub: mart, ak, dam, buz, kaz
spread: nine, on, ses, boru, fare
grind: gerdan, otlak, ovmak, ak, kent
cut: dam, cam, ses, ok, ot
jolt: yorgan, kasket, kent, kulp, otlak
shake: boru, nine, turna, hani, fare
pour: on, ses, ince, at, ile
fill: on, boru, ses, dam, cam
wrap: boru, cam, ip, on, dam
carry: boru, nine, on, ses, dam
drag: cam, dam, siz, hat, ak
pull: pus, dam, hat, ok, cam
keep: on, ok, dam, at, nine
throw: on, ok, hat, nine, ot
catch: on, dam, ok, ot, mart
grab: dam, ok, ot, mart, boru
hide: on, nine, boru, iri, usta
divide: nine, on, boru, ses, usta
send: on, ok, ses, ot, nine
bring: on, had, ok, dam, hat
add: on, ad, ip, bin, ot
get: on, ok, ot, post, ses
receive: on, had, at, nine, ses
take: nine, on, at, had, boru
choose: on, nine, at, boru, ses
select: on, ses, boru, usta, ot
preserve: nine, on, iri, usta, abi
hinder: hata, hala, hissetmek, hemen, hasta
spoil: otlak, kulp, yurt, ovmak, mart
destroy: on, boru, dam, nine, ses
give: on, nine, had, ince, ses
promise: iri, boru, ada, usta, nine
praise: cebir, kafa, yorgan, otlak, artmak
kiss: kasket, kent, kulp, kafa, keder
rock: adam, dam, cam, ekim, boru
wake: usta, nine, boru, iri, ekim
guide: nine, boru, usta, iri, on
teach: tepmek, tepe, teyze, cebir, yorgan
instruct: in, inmek, inlemek, on, oraya
bring up: oraya, had, on, orada, onarmak
lead: boru, usta, nine, raf, adam
urge: on, boru, ince, oraya, toz
let: varmak, on, had, hat, ince
invite: iri, usta, on, nine, boru
unite: cebir, nine, usta, yorgan, boru
visit: at, on, ekim, boru, oraya
meet: at, on, ekim, ay, adam
assemble: boru, nine, on, turna, ses
play: nine, on, ekim, ok, hat
sing: ay, ok, ses, hat, son
dance: nine, usta, iri, artmak, ekim
separate: cebir, ense, seksen, ses, sebep
rescue: resim, resmini yapmak, sopa, cebir, boru
guard: dam, mart, boru, son, cam
protect: on, boru, dam, ses, ok
defend: on, nine, usta, oraya, raf
brawl: batak, bayan, baba, bellek, bilmek
shoot: ok, dam, hat, mart, ekim
win: bin, on, sen, ot, yen
annoy: yorgan, donmak, otlak, gerdan, yahut
beat: hat, tat, adam, nine, ekim
kick: ok, ekim, kim, dam, pak
sting: otlak, kent, yorgan, kayak, gerdan
shove: otlak, yorgan, ovmak, yahut, onarmak
steal: mart, taze, boru, ve, yara
disturb: otlak, mart, ot, turna, ses
bother: boz, boya, bozmak, boynuz, yorgan
conceal: cebir, onarmak, oraya, tepmek, cereyan
deceive: daire, oraya, cebir, dede, orada
cheat: cebir, torba, daire, yorgan, aile
kill: ok, dam, on, ak, ot
dwell: dilim, duman, dert, dolu, diz
gather: on, nine, ses, boru, iri
pick: dam, ok, ses, mart, on
hunt: ekim, mart, usta, raf, boru
herd: her yerde, her zaman, gerdan, oraya, her şey
tie up: oraya, boru, orada, turna, yurt
feed: boru, fare, ad, ses, cam
chop: ekim, dam, kim, ok, boru
ripen: yorgan, oraya, cebir, gerdan, boru
cook: ekim, ok, adam, kim, dam
bake: batak, baba, bayan, bellek, bilmek
fry: fayda, fincan, batak, yorgan, kulp
stir: kent, ak, kurt, yorgan, kayak
knit: artmak, kasket, keder, kent, kulp
sew: sebep, seksen, sevmek, yorgan, cebir
dye: dolu, duman, dilim, dert, diz
wash: dam, ok, boru, ak, cam
wipe: boru, nine, on, turna, iri
rinse: bazan, oraya, boru, gerdan, torba
sweep: sopa, sandal, sene, soba, sincap
bath: batak, bayan, baba, bellek, beyin
take off: oraya, turna, orada, on iki, on
put on: on, oraya, onarmak, on bir, orada
get dressed: oraya, turna, on, getirmek, ok
decorate: nine, boru, on, turna, ok
say: saymak, sayesinde, sayı, ay, ok
speak: sopa, sene, sandal, soba, sabit
chat: hat, tat, ekim, ot, cam
ask: ok, ak, ekim, on, ay
request: abi, ip, post, iri, bin
tell: on, ok, at, ot, hat
convey: ses, oraya, toz, cebir, onarmak
brag: yorgan, otlak, ovmak, yollamak, yurt
translate: iri, usta, boru, nine, abi
think: ok, nine, ekim, on, iz
believe: bel, oraya, cebir, yorgan, ayna
notice: boru, on, iri, ses, usta
recognize: toz, oraya, on, orada, onarmak
grasp: otlak, ovmak, kulp, yorgan, cebir
understand: on, oraya, inmek, toz, orada
learn: on, nine, boru, ekim, iri
know: ok, on, had, at, hat
remember: on, ok, ince, at, hat
forget: on, ok, hat, at, had
measure: on, ses, boru, dam, ot
calculate: on, boru, nine, abi, iri
read: on, ses, ot, boru, iri
draw: on, nine, boru, cam, ses
write: nine, on, iri, usta, ada
own: on, nine, had, dam, hat
buy: on, at, boru, nine, oraya
sell: on, boru, at, ok, oraya
pay for: oraya, orada, on, at, on iki
pay: fare, ay, usta, ses, ok
rule: on, ot, ses, boru, hat
endure: onarmak, dayak, oraya, otlak, turna
