eye: eye, face, skin, heart, throat
ear: ear, throat, heart, mouth, heel
nose: nose, nail, nape, nasty, naked
mouth: mouth, throat, neck, heart, foot
tooth: tooth, together, toe, shoulder, noose
tongue: tongue, tinkle, tumble, towel, tremble
lip: lip, leg, heel, cup, lick
cheek: cheek, cheat, ache, bother, shove
face: face, edge, piece, guide, alone
forehead: forehead, neck, throat, heart, mouth
hair: hair, skin, heart, shirt, chair
moustache: moustache, midge, mush, mushroom, merry
beard: beard, be alive, be cold, be afraid, be noisy
chin: chin, lick, wing, joy, doll
jaw: jaw, belt, rock, stone, gold
throat: throat, mouth, neck, heart, chest
neck: neck, chest, throat, mouth, foot
nape: nape, nasty, naked, nail, nose
head: head, neck, box, track, face
back: back, right, ahead, lock, stream
spine: spine, spade, spider, spoon, spoil
belly: belly, believe, bosom, filth, elbow
navel: navel, ribbon, bosom, button, dash
bosom: bosom, filth, swallow, boss, stingy
chest: chest, neck, throat, mouth, heart
breast: breast, breath, heart, breathe, chest
shoulder: shoulder, willow, tooth, neck, evening
arm: arm, assemble, leg, wrap, wing
elbow: elbow, elk, delicate, belly, owl
hand: hand, neck, foot, finger, mouth
palm: palm, pouch, puzzle, midge, sweep
finger: finger, foot, needle, ribbon, neck
fingernail: fingernail, frost, fence, fry, familiar
nail: nail, nasty, naked, nape, narrow
toe: toe, tooth, together, shoulder, noose
foot: foot, neck, heel, finger, mouth
heel: heel, neck, foot, throat, ear
knee: knee, kettle, knot, kiss, neck
thigh: thigh, thunder, thick, thaw, thither
leg: leg, neck, wing, foot, cap
body: body, figure, piece, face, pattern
skin: skin, throat, hair, brain, heart
blood: blood, heart, water, earth, skin
vein: vein, ache, alone, sleeve, fever
sinew: sinew, sin, rinse, knot, bosom
bone: bone, stone, ice, brain, skin
brain: brain, heart, skin, mind, throat
heart: heart, brain, throat, earth, mouth
stomach: stomach, sting, stir, stingy, stupid
liver: liver, louse, lair, ladder, knot
breath: breath, breast, breathe, bother, roar
hunger: hunger, happiness, hither, hinder, hurry
tear: tear, tear off, teach, seize, tie
flavour: flavour, climb, slim, clay, jolt
odour: odour, smell, flavour, decay, jolt
sleep: sleep, laughter, pain, alone, dream
dream: dream, wish, shadow, truth, alone
sky: sky, shadow, fox, joy, moon
sun: sun, moon, earth, forest, green
moon: moon, owl, earth, shadow, sun
star: star, moon, shadow, owl, blue
air: air, water, ice, earth, fire
wind: wind, earth, rain, dust, flow
wave: wave, edge, noise, tone, line
water: water, oil, river, ice, fire
stone: stone, wood, glass, rock, ice
soil: soil, so, produce, noose, alone
ground: ground, earth, track, round, pipe
earth: earth, moon, forest, heart, shadow
dust: dust, sand, fish, ice, rock
smoke: smoke, smell, midge, jolt, swarm
spark: spark, sparkle, assemble, dash, wrap
fire: fire, ice, shadow, forest, earth
light: light, heavy, smooth, shadow, mirror
shadow: shadow, dream, owl, evil, moon
weather: weather, visit, river, guide, town
fog: fog, flock, frost, fry, fence
cloud: cloud, shadow, edge, stream, box
rain: rain, rainbow, snow, moon, laughter
snow: snow, rain, rainbow, moon, winter
ice: ice, stone, pipe, edge, blue
frost: frost, fog, fry, flock, fence
chill: chill, chime, chicken, jolt, kiss
heat: heat, flow, light, decay, water
hoarfrost: hoarfrost, moustache, roar, fingernail, bother
rainbow: rainbow, rain, moon, owl, flower
thunder: thunder, thaw, thigh, thick, thither
current: current, correct, first, other, prepare
drop: drop, move, alter, jump, destroy
foam: foam, assemble, box, wrap, ribbon
dirt: dirt, dwell, dive, dishes, damp
lake: lake, river, south, east, north
swamp: swamp, swallow, swan, swim, swarm
moor: moor, oar, goose, moon, roar
meadow: meadow, meat, forest, willow, sheep
forest: forest, river, owl, fish, shadow
hill: hill, forest, brook, river, owl
elevation: elevation, eagle, guide, rise, area
mountain: mountain, river, forest, campfire, hill
summit: summit, assemble, day, hunt, circle
cave: cave, cove, cough, cuckoo, midge
slope: slope, circle, distance, wave, edge
source: source, assemble, read, move, prepare
brook: brook, rich, joy, hunt, hill
river: river, forest, moon, winter, town
shore: shore, river, forest, hill, shadow
coast: coast, forest, roar, goose, pace
land: land, forest, town, earth, church
sea: sea, tea, river, ice, forest
cove: cove, cave, cough, cuckoo, budge
island: island, beautiful, willow, everywhere, old
flower: flower, leaf, fish, bird, owl
grass: grass, fish, forest, flower, leaf
root: root, branch, assemble, wrap, slice
tree: tree, snake, edge, slice, forest
trunk: trunk, trousers, grasp, bracket, climb
bark: bark, broom, bend, budge, butter
limb: limb, leg, lip, wing, budge
branch: branch, stream, assemble, guide, piece
leaf: leaf, flower, fish, ribbon, tree
birch: birch, fir, willow, brook, berry
pine: pine, stone, tree, white, ice
willow: willow, shoulder, tomorrow, island, brook
fir: fir, dash, hunt, guard, owl
horn: horn, worm, wing, lick, guard
feather: feather, fever, spade, fringe, eagle
fur: fur, doll, fir, owl, hair
wing: wing, swing, ring, shadow, track
claw: claw, climb, clay, swallow, slab
tail: tail, head, wrap, track, assemble
egg: egg, fish, bread, soup, pig
nest: nest, assemble, track, dash, owl
lair: lair, louse, ladder, liver, budge
animal: animal, bird, fish, horse, dog
flock: flock, fry, fog, frost, flee
cow: cow, pig, crow, owl, dog
bull: bull, bear, owl, doll, fox
horse: horse, dog, bird, animal, snake
sheep: sheep, beard, alone, meat, cow
pig: pig, dog, fish, duck, cow
dog: dog, horse, bird, pig, owl
cat: cat, dog, pig, animal, bird
bear: bear, owl, bird, fish, fox
squirrel: squirrel, sweep, sack, sleigh, sick
elk: elk, elbow, owl, kettle, knot
fox: fox, owl, bear, wolf, shadow
hare: hare, ware, crow, pace, owl
mouse: mouse, snake, human, horse, move
wolf: wolf, owl, fox, bear, shadow
bird: bird, owl, fish, animal, bear
swarm: swarm, sway, swallow, swan, swim
chicken: chicken, chill, chime, mushroom, fish
cock: cock, lick, duck, crow, pick
goose: goose, go, go away, go in, noose
eagle: eagle, elevation, owl, rise, guide
duck: duck, fish, owl, bird, pig
owl: owl, bird, bear, fox, doll
crane: crane, cradle, fringe, swan, swallow
crow: crow, owl, fox, shadow, duck
cuckoo: cuckoo, cove, cave, cough, moustache
swan: swan, swallow, swarm, swim, swamp
fish: fish, bird, duck, worm, bear
perch: perch, perish, chime, swallow, knot
pike: pike, promise, edge, guide, assemble
snake: snake, worm, owl, fish, tree
worm: worm, fish, snake, pig, bird
spider: spider, spoon, spade, spine, spoil
ant: ant, hunt, guard, horn, crow
louse: louse, lair, ladder, liver, midge
midge: midge, merry, mush, moustache, milk
fly: fly, shoot, fish, dream, bird
butterfly: butterfly, butter, broom, budge, bitter
berry: berry, flower, summer, fish, forest
apple: apple, berry, flower, ribbon, assemble
mushroom: mushroom, mush, moustache, milk, midge
onion: onion, like, produce, everywhere, assemble
seed: seed, fish, feed, flower, leaf
grain: grain, grasp, grind, grumble, flavour
hay: hay, joy, brook, lay, way
husk: husk, husband, bosom, kiss, shove
pit: pit, wing, hit, pot, track
trap: trap, wrap, assemble, destroy, rule
noose: noose, alone, everywhere, mistake, leave
track: track, assemble, finish, guide, wrap
ashes: ashes, alone, rush, wish, daughter
filth: filth, bosom, believe, calm, evil
iron: iron, gold, silver, stone, glass
gold: gold, silver, iron, stone, coal
silver: silver, gold, black, yellow, blue
coal: coal, gold, oil, stone, sand
glass: glass, wood, stone, cloth, round
clay: clay, claw, climb, slab, slim
sand: sand, dust, stone, rock, gold
human: human, animal, different, produce, own
man: man, woman, girl, boy, friend
woman: woman, girl, teacher, man, wife
child: child, woman, daughter, girl, teacher
boy: boy, girl, woman, daughter, father
girl: girl, boy, woman, daughter, owl
family: family, daughter, church, parents, staff
grandfather: grandfather, grandmother, father, old, daughter
grandmother: grandmother, grandfather, daughter, mother, beautiful
parents: parents, people, teacher, daughter, staff
father: father, mother, daughter, doctor, wife
mother: mother, father, daughter, wife, woman
son: son, daughter, soon, again, friend
daughter: daughter, wife, father, mother, alone
brother: brother, roar, father, bother, tomorrow
sister: sister, sick, sack, speak, sweep
uncle: uncle, aunt, tomorrow, become, stingy
aunt: aunt, a little, a hundred, a thousand, daughter
husband: husband, husk, daughter, father, wife
wife: wife, daughter, mother, father, alone
joy: joy, shine, rich, daughter, laughter
laughter: laughter, alone, truth, pain, daughter
happiness: happiness, hunger, hither, hurry, happen
grief: grief, happiness, laughter, hunger, pain
wish: wish, dream, remember, forget, bring
desire: desire, seesaw, misfortune, believe, alone
spirit: spirit, shadow, dream, moon, evil
thought: thought, reason, truth, mind, meaning
memory: memory, pattern, assemble, edge, promise
mind: mind, brain, truth, thing, thought
meaning: meaning, reason, alone, again, like
reason: reason, meaning, again, alone, thing
truth: truth, laughter, reason, alone, death
talk: talk, think, drink, story, learn
fairy tale: fairy tale, famous, fence, familiar, frost
story: story, piece, dream, guide, friend
message: message, promise, move, notice, invite
news: news, business, guide, shop, press
name: name, length, year, amount, age
puzzle: puzzle, pouch, palm, sweep, pattern
speech: speech, voice, memory, laughter, language
language: language, guide, pattern, voice, speech
voice: voice, speech, guide, tone, face
word: word, pattern, letter, piece, friend
sign: sign, pass, reason, hold, own
call: call, assemble, move, rule, tell
noise: noise, wave, damage, tone, edge
sound: sound, noise, mind, tone, dream
tone: tone, edge, alone, piece, wave
song: song, story, thing, friend, piece
calm: calm, believe, climb, gentle, filth
people: people, parents, friend, staff, alone
nation: nation, town, friend, thing, country
work: work, track, piece, move, friend
guest: guest, staff, friend, gift, guide
gift: gift, shirt, friend, hunt, piece
game: game, guide, promise, slice, move
company: company, business, staff, guide, firm
help: help, guide, prepare, assemble, stop
friend: friend, daughter, again, thing, alone
companion: companion, guide, assemble, stream, friend
matter: matter, meaning, alone, reason, measure
count: count, amount, length, correct, move
sort: sort, move, count, correct, draw
piece: piece, assemble, guide, slice, notice
part: part, piece, step, week, day
half: half, full, two, old, one
circle: circle, ribbon, assemble, pattern, piece
cross: cross, circle, shadow, edge, fox
line: line, slice, edge, move, circle
stroke: stroke, damage, bite, medicine, rise
gap: gap, circle, edge, assemble, hole
distance: distance, length, move, damage, area
area: area, distance, guide, place, circle
space: space, guide, pace, edge, alone
place: place, guide, piece, notice, move
side: side, edge, wide, line, pipe
middle: middle, old, third, second, little
item: item, pattern, piece, button, move
thing: thing, again, reason, friend, alone
fringe: fringe, crane, bracket, guide, grasp
edge: edge, move, slice, guide, assemble
corner: corner, round, floor, decorate, chair
tip: tip, step, wrap, track, pick
end: end, endure, correct, finish, hold
hole: hole, piece, pole, damage, pipe
angle: angle, circle, distance, slope, length
pattern: pattern, piece, ribbon, circle, wrap
size: size, length, height, weight, age
length: length, height, amount, size, weight
height: height, length, weight, size, amount
weight: weight, length, height, amount, strength
amount: amount, length, count, measure, correct
heap: heap, slice, wrap, assemble, pattern
row: row, length, day, step, word
boat: boat, chair, shirt, fish, track
oar: oar, roar, noose, budge, guide
sleigh: sleigh, sack, sweep, squirrel, sick
ski: ski, boat, ice, winter, hunt
campfire: campfire, summer, rainbow, forest, grandmother
load: load, add, source, read, move
walk: walk, shoot, hunt, jump, move
step: step, move, measure, piece, wrap
north: north, south, east, west, old
south: south, north, east, west, old
west: west, east, south, north, brook
east: east, west, south, north, old
wood: wood, glass, stone, cloth, round
board: board, pattern, assemble, guide, branch
slab: slab, slim, clay, climb, claw
bracket: bracket, brag, grasp, fringe, stream
pole: pole, hole, circle, pipe, track
stick: stick, track, wrap, pick, rock
staff: staff, teacher, parents, family, people
pipe: pipe, bridge, gate, line, bucket
house: house, chair, town, church, boat
home: home, guide, business, space, medicine
stove: stove, sting, stir, stupid, stomach
floor: floor, roof, chair, shelf, door
table: table, board, figure, pattern, box
chair: chair, shirt, door, boat, mirror
cradle: cradle, crane, climb, fringe, claw
bed: bed, chair, sink, shelf, door
shelf: shelf, chair, shirt, finish, box
box: box, wrap, bucket, track, circle
window: window, game, this, body, table
door: door, chair, gate, mirror, shirt
gate: gate, edge, assemble, pipe, guide
fence: fence, famous, flock, frost, familiar
roof: roof, floor, wood, glass, sink
ladder: ladder, louse, lair, liver, towel
broom: broom, budge, bend, butter, bark
spade: spade, spoon, spider, spine, spoil
shovel: shovel, shove, shout, shoe, spoon
fork: fork, assemble, wrap, slice, ribbon
spoon: spoon, spade, spoil, spider, spine
knife: knife, slice, pipe, snake, edge
net: net, chat, spark, assemble, boot
hook: hook, wrap, game, button, pattern
handle: handle, move, assemble, make, prepare
lock: lock, stream, pick, hold, assemble
picture: picture, cover, guide, piece, stream
figure: figure, assemble, pattern, piece, slice
doll: doll, owl, shirt, daughter, girl
pouch: pouch, palm, puzzle, sweep, knot
bundle: bundle, wrap, assemble, slice, promise
bag: bag, shirt, cup, bucket, box
bucket: bucket, track, box, assemble, ribbon
cover: cover, guide, stream, picture, visit
dishes: dishes, dwell, dive, dirt, diligent
sack: sack, sick, sweep, sleigh, succeed
cup: cup, dish, bag, pick, finish
pot: pot, cup, cap, pit, dish
kettle: kettle, knot, kiss, knee, jolt
meal: meal, food, gift, slice, day
food: food, health, drink, bread, fish
dish: dish, fish, wish, dash, finish
meat: meat, meadow, fish, bread, soup
corn: corn, fish, grass, bread, horn
mush: mush, mushroom, midge, mend, moustache
bread: bread, soup, food, fish, egg
slice: slice, assemble, wrap, piece, move
fat: fat, evil, sweet, blind, bad
butter: butter, butterfly, bake, broom, budge
oil: oil, water, coal, gold, stone
salt: salt, seed, dust, fish, slice
soup: soup, bread, tea, fish, shirt
honey: honey, hurry, happiness, hunger, hither
milk: milk, midge, melt, merry, mush
tea: tea, soup, flower, ice, tree
leather: leather, leash, clever, chair, grey
wool: wool, bother, noose, roar, scarf
cloth: cloth, shirt, glass, chair, wood
needle: needle, finger, pipe, hole, ribbon
thread: thread, pattern, ribbon, wrap, slice
button: button, ribbon, item, pattern, wrap
knot: knot, kiss, kettle, knee, jolt
paint: paint, finish, decorate, sink, fill
clothes: clothes, shirt, cloth, shoe, chair
shirt: shirt, gift, chair, doll, piece
collar: collar, scarf, doll, sleeve, grasp
sleeve: sleeve, sweep, sleigh, sack, sick
trousers: trousers, shove, thither, grasp, bosom
belt: belt, bucket, pipe, shirt, track
cap: cap, gap, guard, wrap, grab
shoe: shoe, shove, shovel, shout, shirt
boot: boot, wrap, assemble, dash, box
ring: ring, wing, circle, hole, ribbon
ribbon: ribbon, wrap, circle, pattern, assemble
comb: comb, wrap, assemble, grab, guard
mirror: mirror, assemble, circle, finish, ribbon
strap: strap, wrap, ribbon, track, assemble
string: string, length, word, rule, stream
leash: leash, leather, clever, noose, seesaw
blanket: blanket, noose, chair, rainbow, shirt
pillow: pillow, doll, shirt, chair, scarf
scarf: scarf, shirt, collar, doll, chair
towel: towel, tumble, tinkle, taste, tongue
force: force, damage, measure, edge, move
strength: strength, reason, meaning, measure, length
health: health, business, wealth, food, staff
illness: illness, alone, pain, laughter, misfortune
pain: pain, laughter, alone, truth, damage
wound: wound, wet, grief, knot, knee
fever: fever, feather, alone, ache, vein
medicine: medicine, guide, alone, pace, produce
bridge: bridge, pipe, edge, gate, guide
well: well, again, still, once, good
pasture: pasture, forest, summer, winter, grass
path: path, pattern, length, board, word
way: way, again, thing, only, alone
road: road, track, town, forest, boat
village: village, town, visit, budge, guide
town: town, church, country, hunt, family
letter: letter, piece, word, pattern, notice
book: book, guide, shop, cover, stream
character: character, pattern, piece, meaning, assemble
newspaper: newspaper, new, noose, everywhere, seesaw
life: life, love, alone, rise, laughter
death: death, truth, laughter, evil, alone
grave: grave, alone, love, bite, face
church: church, town, family, business, staff
sin: sin, sinew, spin, chin, sing
god: god, father, truth, evil, mother
worker: worker, teacher, enemy, board, staff
boss: boss, hunt, dash, guard, friend
master: master, assemble, guide, piece, doctor
doctor: doctor, teacher, father, daughter, friend
teacher: teacher, staff, doctor, parents, daughter
money: money, profit, gift, amount, friend
business: business, company, church, health, staff
shop: shop, visit, sell, stream, assemble
price: price, amount, size, time, age
ware: ware, pace, assemble, ahead, piece
profit: profit, wealth, money, meaning, gift
wealth: wealth, health, profit, truth, money
world: world, country, earth, dream, church
country: country, town, family, forest, church
state: state, guide, promise, branch, area
king: king, joy, brook, father, old
power: power, powerful, force, flow, strength
border: border, edge, shadow, circle, branch
war: war, evil, death, fight, alone
enemy: enemy, friend, destroy, evil, damage
violence: violence, alone, reason, mistake, urge
fight: fight, shoot, hunt, destroy, alone
bow: bow, crow, wing, owl, shadow
arrow: arrow, button, cover, stream, guide
gun: gun, shadow, owl, bear, doll
mistake: mistake, alone, misfortune, again, urge
lie: lie, tie, alone, urge, tone
damage: damage, decay, produce, force, guide
misfortune: misfortune, mistake, alone, disappear, daughter
fault: fault, damage, decay, correct, hole
age: age, time, length, size, amount
conclusion: conclusion, convey, conceal, meaning, reason
time: time, distance, age, move, damage
day: day, week, year, month, night
morning: morning, evening, night, tomorrow, summer
noon: noon, pace, ahead, soon, alone
evening: evening, everywhere, only, night, like
night: night, winter, summer, shadow, moon
week: week, day, year, month, today
month: month, year, week, day, amount
year: year, week, month, day, amount
spring: spring, fall, summer, winter, spark
summer: summer, winter, fall, night, beautiful
autumn: autumn, summer, winter, fall, forest
winter: winter, summer, fall, night, forest
January: January, February, November, December, September
February: February, November, January, October, December
March: March, July, February, September, November
April: April, June, July, October, September
May: May, June, August, September, March
June: June, April, July, September, January
July: July, September, November, October, January
August: August, September, November, July, October
September: September, October, November, December, February
October: October, November, September, December, February
November: November, October, December, September, February
December: December, November, September, October, February
Monday: Monday, Tuesday, Wednesday, Thursday, Saturday
Tuesday: Tuesday, Thursday, Wednesday, Monday, Saturday
Wednesday: Wednesday, Thursday, Tuesday, Monday, Saturday
Thursday: Thursday, Tuesday, Wednesday, Friday, Saturday
Friday: Friday, Thursday, Wednesday, Tuesday, Saturday
Saturday: Saturday, Thursday, Wednesday, Sunday, Tuesday
Sunday: Sunday, Saturday, Monday, Thursday, Friday
big: big, little, dirty, old, beautiful
little: little, beautiful, big, old, sweet
long: long, short, smooth, finish, old
short: short, long, good, second, smooth
wide: wide, white, blue, edge, one
narrow: narrow, naked, nail, nasty, nape
dense: dense, produce, smooth, heavy, weak
thick: thick, thaw, thunder, thigh, thither
thin: thin, smooth, green, wrap, flat
delicate: delicate, delicious, calm, beautiful, elbow
firm: firm, reason, alone, company, piece
flat: flat, round, wrap, smooth, circle
smooth: smooth, soft, spread, wrap, correct
hard: hard, hardly, soft, smooth, heavy
soft: soft, hard, smooth, sweet, fresh
round: round, decorate, grey, finish, glass
pointed: pointed, measure, different, assemble, piece
sharp: sharp, smooth, produce, beautiful, good
blunt: blunt, blow, grasp, slim, climb
heavy: heavy, light, smooth, different, produce
beautiful: beautiful, cool, decorate, old, fresh
hot: hot, sweet, cool, fresh, warm
warm: warm, cold, cool, sweet, beautiful
cold: cold, warm, hot, fresh, cool
cool: cool, beautiful, good, decorate, old
fresh: fresh, beautiful, sweet, cool, good
damp: damp, dirt, dwell, dive, dishes
wet: wet, wound, dry, jolt, damp
dry: dry, cold, fresh, warm, wash
full: full, old, short, half, correct
empty: empty, assemble, wrap, prepare, move
open: open, closed, empty, read, prepare
closed: closed, different, correct, empty, assemble
clean: clean, assemble, prepare, wrap, make
dirty: dirty, evil, old, big, sweet
raw: raw, prepare, wrap, fresh, clean
ripe: ripe, assemble, produce, rise, slice
delicious: delicious, delicate, fresh, beautiful, believe
sweet: sweet, beautiful, fresh, little, dirty
bitter: bitter, butter, broom, budge, bend
sour: sour, sick, sack, sweep, sleigh
bright: bright, dark, beautiful, green, black
dark: dark, black, bright, shadow, dirty
black: black, white, grey, yellow, blue
white: white, black, blue, grey, yellow
red: red, yellow, blue, green, black
yellow: yellow, blue, white, black, red
blue: blue, white, yellow, green, black
green: green, blue, yellow, black, white
grey: grey, white, black, yellow, blue
colourful: colourful, flower, beautiful, decorate, rainbow
cheap: cheap, buy, sell, beautiful, cool
dear: dear, deceive, deaf, decrease, meet
precious: precious, become, evil, recognize, rich
blind: blind, evil, old, shadow, bad
deaf: deaf, dear, deceive, decrease, teach
powerful: powerful, power, different, good, produce
strong: strong, weak, produce, good, correct
weak: weak, strong, correct, different, measure
slim: slim, slab, climb, swim, flavour
pretty: pretty, beautiful, cool, very, decorate
evil: evil, bad, shadow, alone, sad
stupid: stupid, sting, stingy, stir, stove
lazy: lazy, assemble, wrap, empty, slice
diligent: diligent, dwell, dishes, dive, dirt
stingy: stingy, sting, stupid, stir, stomach
clever: clever, seesaw, gentle, leash, eleven
skilful: skilful, diligent, stingy, shove, seesaw
merry: merry, midge, mush, milk, mend
gentle: gentle, clever, mistake, alone, calm
hungry: hungry, young, stingy, hang, evil
sick: sick, sack, sweep, suddenly, succeed
naked: naked, nasty, nail, nape, narrow
sad: sad, bad, evil, alone, beautiful
living: living, beautiful, grow, alone, own
good: good, bad, beautiful, cool, own
bad: bad, good, sad, evil, old
correct: correct, measure, prepare, choose, different
nasty: nasty, naked, nail, nape, narrow
true: true, alone, love, like, one
old: old, beautiful, former, new, young
new: new, old, choose, own, assemble
former: former, between, visit, old, meet
aged: aged, young, old, rich, beautiful
young: young, meet, old, beautiful, former
poor: poor, bother, noose, aunt, meet
rich: rich, joy, old, lick, beautiful
familiar: familiar, famous, flee, flock, fry
famous: famous, familiar, fence, fifty, frost
foreign: foreign, other, own, business, family
different: different, between, other, produce, correct
near: near, visit, between, former, like
far: far, way, war, hear, alone
left: left, right, leave, correct, move
right: right, left, correct, leave, choose
other: other, different, between, produce, own
first: first, second, last, third, correct
second: second, third, first, two, correct
third: third, second, first, six, one
last: last, first, second, third, only
alone: alone, again, daughter, once, urge
at once: at once, at first, at that time, afterwards, and
together: together, alone, again, tooth, afterwards
suddenly: suddenly, succeed, sick, sweep, speak
instantly: instantly, always, already, hardly, fresh
later: later, again, then, once, soon
now: now, again, only, already, today
today: today, again, remember, now, soon
tomorrow: tomorrow, joy, today, yesterday, willow
soon: soon, again, alone, once, sometimes
then: then, and, again, that, or
yesterday: yesterday, today, remember, again, like
once: once, again, already, sometimes, alone
at that time: at that time, at once, at first, afterwards, next to
afterwards: afterwards, like, again, at once, through
before: before, remember, like, prepare, afterwards
at first: at first, at once, at that time, next to, afterwards
sometimes: sometimes, like, again, often, that
often: often, sometimes, already, that, always
always: always, already, still, again, only
never: never, always, already, not, still
here: here, alone, again, soon, today
hither: hither, hinder, happen, happiness, hurry
hence: hence, happen, hither, hinder, happiness
there: there, here, alone, love, never
thither: thither, thaw, thou, thunder, thick
ahead: ahead, alone, again, assemble, reason
forward: forward, correct, ahead, stream, move
backward: backward, cover, former, visit, leave
below: below, above, again, only, meaning
down: down, finish, shoot, stream, destroy
above: above, below, alone, like, guide
up: up, down, ahead, assemble, keep
everywhere: everywhere, alone, everything, only, like
not: not, only, already, always, again
a little: a little, a hundred, a thousand, aunt, like
hardly: hardly, hard, still, soft, always
very: very, only, always, sometimes, feel
so: so, sometimes, like, again, then
still: still, always, already, again, only
only: only, again, that, sometimes, like
already: already, always, again, once, not
again: again, alone, soon, only, already
in vain: in vain, in front of, instruct, at once, afterwards
in front of: in front of, in vain, at that time, next to, at once
behind: behind, believe, like, forget, remember
under: under, understand, through, between, above
through: through, between, like, and, that
next to: next to, at first, at once, like, everywhere
between: between, through, like, different, why
because of: because of, through, and, sometimes, that
this: this, today, assemble, one, again
that: that, and, only, sometimes, like
everything: everything, only, thing, remember, again
I: I, we, they, you, never
you: you, they, again, always, we
thou: thou, thither, thaw, thunder, thick
he: he, that, and, former, like
we: we, they, you, who, always
they: they, you, then, we, again
what: what, that, why, how, different
who: who, they, already, you, again
where: where, like, why, between, that
where ... to: where ... to, where, together, at that time, at once
how: how, why, how much, howl, like
why: why, how, like, that, sometimes
how much: how much, how, why, howl, because of
one: one, three, two, alone, nine
two: two, three, four, five, six
three: three, two, five, four, seven
four: four, six, eight, three, seven
five: five, three, eight, seven, nine
six: six, eight, four, seven, five
seven: seven, eight, six, nine, five
eight: eight, six, seven, four, five
nine: nine, seven, eight, five, three
ten: ten, eight, seven, six, nine
eleven: eleven, nine, seven, eight, six
twelve: twelve, eight, nine, six, seven
twenty: twenty, sixty, eighty, eight, seven
thirty: thirty, thunder, thick, thaw, thither
forty: forty, eighty, sixty, ninety, twenty
fifty: fifty, famous, familiar, fence, frost
sixty: sixty, eighty, six, eight, seven
seventy: seventy, ninety, seize, seesaw, eighty
eighty: eighty, sixty, eight, six, seven
ninety: ninety, eighty, sixty, seventy, thirty
a hundred: a hundred, a thousand, a little, aunt, eighty
a thousand: a thousand, a hundred, a little, aunt, two
and: and, that, or, then, through
or: or, and, then, that, through
stand: stand, stand up, hold, shoot, alone
sit: sit, sit down, stand, hold, hit
hang: hang, hang up, hold, shoot, wing
become: become, once, be noisy, only, recognize
happen: happen, hurry, hither, happiness, hinder
begin: begin, start, move, make, prepare
change: change, move, choose, make, assemble
rise: rise, shine, alone, pace, promise
set: set, add, get, move, handle
shine: shine, rise, alone, pace, love
blow: blow, blunt, climb, slim, claw
stream: stream, assemble, destroy, ahead, move
flow: flow, decay, measure, assemble, edge
revolve: revolve, jolt, sparkle, shine, assemble
sway: sway, swarm, swallow, swan, swim
swing: swing, wing, track, chair, lift
fall: fall, summer, winter, fall ill, fall asleep
burn: burn, shoot, destroy, lick, hold
freeze: freeze, slice, wipe, move, assemble
thaw: thaw, thither, thunder, thick, thou
melt: melt, midge, milk, mush, mend
boil: boil, bother, rinse, roar, bake
rot: rot, hunt, grab, put, cap
decay: decay, damage, flow, measure, strength
snap: snap, wrap, grab, dash, track
sink: sink, chair, finish, glass, dish
pass: pass, hold, move, assemble, fill
appear: appear, again, reason, alone, feel
disappear: disappear, misfortune, alone, appear, succeed
decrease: decrease, deceive, dear, increase, deaf
increase: increase, produce, measure, receive, choose
grow: grow, bring, gather, shoot, know
sparkle: sparkle, spark, rustle, assemble, shine
be noisy: be noisy, be annoyed, be alive, be afraid, be born
chime: chime, chill, chicken, shove, jolt
tinkle: tinkle, tumble, taste, towel, tremble
roar: roar, groan, bother, jolt, tinkle
rustle: rustle, sparkle, assemble, mistake, goose
howl: howl, how, why, everywhere, how much
whistle: whistle, swallow, shove, shout, chime
shout: shout, shove, shovel, shoe, jolt
groan: groan, roar, bother, joy, alone
tremble: tremble, tinkle, tumble, tongue, taste
be alive: be alive, be noisy, be annoyed, be afraid, be born
be born: be born, be alive, be afraid, be annoyed, be noisy
breathe: breathe, budge, bake, bend, breath
drink: drink, food, pick, shoot, eat
eat: eat, drink, grow, cook, bring
swallow: swallow, swan, swarm, swim, swamp
get tired: get tired, get dressed, get up, get, alone
fall asleep: fall asleep, fall ill, fall, summer, winter
wake up: wake up, wake, alone, take off, pick up
get up: get up, get dressed, get tired, get, bring up
relax: relax, grasp, assemble, disturb, believe
fall ill: fall ill, fall asleep, fall, summer, winter
be ill: be ill, be cold, be born, be afraid, be alive
ache: ache, alone, urge, rise, guide
cough: cough, cove, cave, cuckoo, grief
recover: recover, protect, destroy, assemble, choose
die: die, lie, alone, move, guide
perish: perish, perch, endure, believe, disappear
move: move, assemble, make, wipe, change
budge: budge, bake, bend, broom, brawl
stand up: stand up, stand, sit down, turn around, chair
sit down: sit down, sit, stand up, wake up, stand
tumble: tumble, tinkle, towel, taste, tremble
pace: pace, alone, urge, rise, guide
go for a walk: go for a walk, go away, go in, take off, be afraid of
rush: rush, hunt, ashes, wish, fox
hurry: hurry, happen, hither, happiness, hinder
dash: dash, assemble, wrap, rush, grab
run: run, move, assemble, wrap, prepare
jump: jump, shoot, move, hunt, ahead
climb: climb, claw, clay, swim, grasp
seesaw: seesaw, seize, separate, seem, sew
creep: creep, grasp, clever, breath, smell
swim: swim, swallow, swan, swarm, swamp
dive: dive, dwell, dishes, dirt, dye
drive: drive, move, guide, rise, assemble
go: go, go in, goose, go away, move
go away: go away, go in, go, goose, go for a walk
depart: depart, leave, forget, again, visit
stop: stop, keep, destroy, forget, correct
go in: go in, go away, go, goose, go for a walk
enter: enter, choose, visit, destroy, receive
come: come, come back, alone, once, again
arrive: arrive, move, assemble, alone, notice
come back: come back, come, go away, look at, take off
stay: stay, keep, feel, always, still
wait: wait, wait for, again, move, hold
wait for: wait for, wait, afterwards, look for, look at
seek: seek, bring, hold, destroy, give
look for: look for, look at, bring up, like, pick up
find: find, choose, prepare, destroy, make
try: try, choose, forget, remember, prepare
prepare: prepare, assemble, make, choose, produce
love: love, alone, shine, like, leave
like: like, remember, forget, sometimes, why
laugh: laugh, laughter, aunt, leash, alone
weep: weep, lick, alone, again, shoot
grumble: grumble, grasp, grind, grain, jolt
be annoyed: be annoyed, be noisy, be alive, be afraid, be born
be afraid: be afraid, be alive, be annoyed, be afraid of, be noisy
be afraid of: be afraid of, be afraid, be alive, be annoyed, be noisy
flee: flee, familiar, flock, fry, famous
escape: escape, move, assemble, destroy, alone
see: see, like, give, remember, leave
look at: look at, look for, bring up, like, remember
watch: watch, meet, remember, stream, visit
hear: hear, remember, meet, bring, give
listen: listen, read, alone, hear, stream
taste: taste, tinkle, tumble, towel, tremble
smell: smell, smoke, jolt, mistake, grasp
feel: feel, bring, appear, alone, again
seem: seem, seize, sew, separate, seesaw
show: show, move, hide, assemble, make
be cold: be cold, be born, be noisy, be alive, be afraid
do: do, like, why, give, can
can: can, why, like, how, that
want: want, bring, like, forget, only
start: start, stop, begin, move, correct
finish: finish, assemble, fill, decorate, prepare
succeed: succeed, sweep, speak, suddenly, sick
turn out: turn out, turn around, turn, bring up, take off
close: close, hide, leave, closed, like
put: put, put on, bring, hold, forget
lay: lay, hold, bring, lick, way
touch: touch, wrap, move, assemble, stream
connect: connect, assemble, move, choose, protect
hang up: hang up, hang, tie up, take off, pick up
pick up: pick up, pick, take off, bring up, look for
leave: leave, give, like, forget, bring
lose: lose, give, leave, forget, like
make: make, prepare, move, assemble, choose
produce: produce, receive, prepare, increase, assemble
build: build, assemble, make, prepare, move
mend: mend, mush, midge, merry, melt
improve: improve, increase, produce, choose, like
alter: alter, destroy, assemble, choose, change
dig: dig, hunt, thing, grab, pick
bend: bend, budge, broom, bake, bath
spin: spin, flow, skin, wave, hole
turn: turn, turn around, turn out, put, hold
turn around: turn around, turn out, turn, take off, bring up
raise: raise, move, choose, make, increase
lift: lift, track, assemble, swing, finish
seize: seize, separate, seesaw, seem, sew
hold: hold, bring, forget, put, seek
press: press, guide, staff, hunt, track
push: push, pull, move, wrap, draw
scrape: scrape, move, assemble, wrap, make
lick: lick, pick, shoot, hold, forget
bite: bite, shine, alone, rise, love
tear off: tear off, tear, teach, tie up, take off
cut off: cut off, cut, take off, pick up, tie up
tie: tie, tie up, tone, bite, pipe
break: break, hold, destroy, shoot, move
knock: knock, knit, knot, shove, kick
hit: hit, shoot, pick, hold, grab
glue: glue, assemble, wrap, slice, wipe
rub: rub, grab, lick, pick, hold
spread: spread, bring, produce, assemble, hold
grind: grind, grasp, grain, grumble, jolt
cut: cut, cut off, pick, fill, put
jolt: jolt, tinkle, knot, budge, kiss
shake: shake, shine, bite, rise, wipe
pour: pour, bring, like, give, meet
fill: fill, finish, wrap, prepare, assemble
wrap: wrap, assemble, move, prepare, slice
carry: carry, bring, hold, take, produce
drag: drag, grab, wrap, track, move
pull: pull, wrap, put, move, fill
keep: keep, bring, hold, leave, forget
throw: throw, wrap, bring, move, assemble
catch: catch, grab, pick, hold, stream
grab: grab, bring, wrap, hold, pick
hide: hide, move, make, choose, change
divide: divide, move, assemble, prepare, choose
send: send, receive, bring, move, choose
bring: bring, give, bring up, hold, seek
add: add, move, make, prepare, choose
get: get, get dressed, get up, get tired, choose
receive: receive, give, produce, choose, make
take: take, give, take off, bring, leave
choose: choose, prepare, assemble, make, give
select: select, choose, assemble, move, notice
preserve: preserve, make, move, destroy, assemble
hinder: hinder, hither, happiness, happen, hurry
spoil: spoil, spoon, spade, spider, spine
destroy: destroy, protect, assemble, forget, choose
give: give, bring, take, receive, leave
promise: promise, assemble, notice, move, guide
praise: praise, alone, grasp, believe, urge
kiss: kiss, knot, kettle, knee, jolt
rock: rock, stone, fish, forest, track
wake: wake, wake up, rise, pace, alone
guide: guide, assemble, notice, piece, move
teach: teach, tear, seize, believe, give
instruct: instruct, in vain, between, protect, understand
bring up: bring up, bring, look for, take off, look at
lead: lead, gold, silver, produce, iron
urge: urge, alone, leave, give, like
let: let, select, see, that, sometimes
invite: invite, promise, guide, move, notice
unite: unite, pace, teach, alone, urge
visit: visit, meet, choose, remember, leave
meet: meet, visit, remember, like, bring
assemble: assemble, prepare, move, gather, wrap
play: play, stream, shoot, visit, assemble
sing: sing, bring, hold, pick, know
dance: dance, shine, love, guide, space
separate: separate, seize, seesaw, seem, sew
rescue: rescue, guide, assemble, escape, move
guard: guard, protect, guide, friend, assemble
protect: protect, destroy, bring, forget, choose
defend: defend, destroy, correct, protect, divide
brawl: brawl, budge, bend, broom, bake
shoot: shoot, hold, hunt, pick, fight
win: win, grab, run, stream, choose
annoy: annoy, bother, tomorrow, believe, mistake
beat: beat, fight, shoot, hit, kick
kick: kick, lick, shoot, pick, bring
sting: sting, stingy, stupid, stir, stomach
shove: shove, shout, shovel, shoe, chime
steal: steal, ache, assemble, move, promise
disturb: disturb, grasp, destroy, protect, measure
bother: bother, boil, alone, annoy, roar
conceal: conceal, convey, conclusion, seize, seesaw
deceive: deceive, dear, deaf, decrease, seize
cheat: cheat, cheek, ache, bother, seize
kill: kill, destroy, shoot, bring, guard
dwell: dwell, dive, dishes, dirt, diligent
gather: gather, assemble, bring, choose, prepare
pick: pick, pick up, choose, hold, lick
hunt: hunt, shoot, rush, pace, pick
herd: herd, calm, noose, gentle, bosom
tie up: tie up, tie, take off, hang up, pick up
feed: feed, seed, food, track, assemble
chop: chop, pick, cook, lick, cut
ripen: ripen, rinse, bother, urge, shove
cook: cook, hunt, pick, lick, chop
bake: bake, budge, butter, bend, brawl
fry: fry, flock, frost, familiar, fog
stir: stir, sting, stupid, stove, stingy
knit: knit, knock, knot, swim, kiss
sew: sew, seem, seize, separate, seesaw
dye: dye, dive, dirt, dwell, dishes
wash: wash, wish, pick, dish, finish
wipe: wipe, move, assemble, make, wrap
rinse: rinse, shine, ripen, wash, shove
sweep: sweep, succeed, sack, sick, sleigh
bath: bath, broom, bend, budge, bark
take off: take off, take, bring up, put on, pick up
put on: put on, put, take off, bring up, look for
get dressed: get dressed, get up, get tired, get, choose
decorate: decorate, beautiful, assemble, finish, cool
say: say, know, bring, remember, again
speak: speak, succeed, sweep, sick, suddenly
chat: chat, dash, friend, assemble, guide
ask: ask, meet, remember, bring, seek
request: request, promise, message, handle, move
tell: tell, bring, give, choose, remember
convey: convey, conclusion, conceal, bring, hold
brag: brag, bracket, grasp, shove, lair
translate: translate, assemble, move, guide, prepare
think: think, know, everything, ahead, bring
believe: believe, belly, alone, urge, remember
notice: notice, guide, promise, meaning, reason
recognize: recognize, produce, like, protect, choose
grasp: grasp, grind, grumble, grain, climb
understand: understand, under, through, between, recognize
learn: learn, choose, assemble, gather, know
know: know, remember, forget, bring, seek
remember: remember, forget, like, leave, know
forget: forget, remember, like, only, bring
measure: measure, assemble, produce, increase, destroy
calculate: calculate, increase, correct, measure, prepare
read: read, stream, move, write, assemble
draw: draw, assemble, wrap, move, destroy
write: write, move, make, read, prepare
own: own, choose, only, protect, bring
buy: buy, cheap, sell, shop, visit
sell: sell, buy, bring, protect, hold
pay for: pay for, pay, sell, look for, bring up
pay: pay, pay for, bring, hold, give
rule: rule, measure, assemble, stream, again
endure: endure, end, alone, destroy, assemble
