eye: stem, zee, lip, worm, door
ear: roken, heet, stem, oor, door
nose: nog, negen, nemen, nacht, niet
mouth: hand, worm, stem, roken, heet
tooth: toon, toen, toenemen, heet, noemen
tongue: tong, tien, tillen, tellen, tijding
lip: lip, heet, stem, kip, nut
cheek: meester, cadeau, nevel, leggen, noemen
face: stem, letter, heet, ring, roken
forehead: overal, handvat, stem, heet, roken
hair: beer, stem, winter, worm, door
moustache: muts, midden, mouw, mug, muis
beard: beven, beek, bezem, beheersen, bevriezen
chin: kin, roken, dan, alom, pees
jaw: heet, roken, stem, ring, worm
throat: worm, stem, heet, hand, ring
neck: hand, stem, worm, heet, ring
nape: nemen, negen, nog, nacht, niet
head: stem, pad, heet, boot, worm
back: top, roken, stem, brief, heet
spine: spoor, spelen, spiegel, spits, spel
belly: beloven, melken, leggen, rinkelen, handvat
navel: navel, rinkelen, pad, stem, worden
bosom: bos, rinkelen, roken, inslapen, stroming
chest: heet, worm, stem, ring, bed
breast: breien, brengen, breed, breken, streep
shoulder: willen, overal, blind, stem, roken
arm: arm, boot, stem, pad, heet
elbow: lepel, cadeau, roken, melken, eiland
hand: hand, handvat, handig, handpalm, handdoek
palm: punt, pap, pantalon, prikken, puntig
finger: worm, hand, stem, ring, beer
fingernail: familie, buidel, toedekken, bruisen, gierig
nail: nog, negen, nemen, nacht, niet
toe: toevoegen, toen, toon, toenemen, noemen
foot: hand, stem, heet, worm, boot
heel: heet, lip, stem, roken, door
knee: knoop, knie, koe, komen, kammen
thigh: thans, leggen, handvat, roken, heet
leg: leggen, heet, lip, arm, roken
body: stem, heet, bot, letter, boot
skin: stem, beer, worm, lip, roken
blood: water, beer, stem, worm, blind
vein: veen, vegen, veer, veertig, meester
sinew: kin, rinkelen, roken, noemen, slapen
bone: stem, worm, ring, water, hand
brain: stem, worm, beer, blind, ring
heart: stem, hart, beer, blind, heet
stomach: strop, stang, stier, stoten, stelen
liver: ladder, lief, luis, lachen, lui
breath: breien, brengen, breed, breken, redden
hunger: helling, honing, heden, houden, hals
tear: teken, tehuis, tegelijk, tekenen, tevergeefs
flavour: fluiten, slim, slank, plank, slapen
odour: heet, ingaan, lopen, ademen, roken
sleep: week, brief, stem, worm, beer
dream: boom, roken, blind, worm, stem
sky: boom, beer, roken, zee, winter
sun: roken, beer, wang, wind, winter
moon: roken, beer, boom, worm, winter
star: roken, door, beer, top, stem
air: water, wind, beer, winter, boom
wind: wind, worm, water, boom, land
wave: ring, wind, stem, worm, heet
water: water, beer, winter, wind, stem
stone: water, beer, door, winter, stem
soil: soep, soort, noemen, tooien, heet
ground: stem, ring, worm, water, hard
earth: stem, worm, beer, blind, water
dust: worm, mist, water, wind, heet
smoke: smal, smelten, slim, zonde, roken
spark: elf, boot, bot, rust, stem
fire: water, wind, beer, winter, worm
light: heet, water, warm, blind, stem
shadow: blind, roken, wolf, stem, elf
weather: winter, beer, lopen, roken, week
fog: fijn, familie, gieten, ginds, golf
cloud: boot, stem, nest, elf, bot
rain: roken, beer, winter, heet, wind
snow: winter, roken, wind, beer, water
ice: beer, winter, olie, water, worm
frost: fijn, familie, gieten, ginds, knoop
chill: koken, komen, kammen, kool, slank
heat: water, wind, heet, stem, beer
hoarfrost: hoeden, hoek, hoorn, hoop, hoen
rainbow: winter, rinkelen, beer, drinken, roken
thunder: thans, rinkelen, roken, zonde, komen
current: last, top, brief, week, stem
drop: put, boot, lopen, heet, bot
foam: stem, worm, boot, elf, plank
dirt: droom, dorp, dansen, doden, dood
lake: olie, winter, dan, ski, zee
swamp: rinkelen, slim, slank, april, roken
moor: moeder, moeras, spoelen, mooi, hoeden
meadow: meester, mei, meedelen, meisje, roeien
forest: winter, wolf, beer, land, stem
hill: hart, winter, roken, boom, blind
elevation: eend, eens, einde, eindigen, aarde
mountain: winter, westen, augustus, baden, rinkelen
summit: worden, week, top, stem, rinkelen
cave: cirkel, midden, knoop, zonde, kammen
slope: stem, ring, week, heet, beer
source: elf, boot, bot, rand, letter
brook: hart, roken, kip, dan, rijk
river: winter, roken, beer, water, stem
shore: winter, roken, blind, boom, stem
coast: noorden, roeren, noemen, spoelen, boord
land: land, eland, wind, heet, water
sea: ski, winter, water, beer, worm
cove: cirkel, zonde, knoop, gieten, ginds
island: inham, ingaan, overal, roken, willen
flower: beer, winter, stem, worm, letter
grass: worm, beer, stem, winter, water
root: boot, stem, bot, elf, worm
tree: stem, worm, beer, ring, door
trunk: trappen, plank, buidel, rond, bot
bark: bitter, brij, bellen, bont, buidel
limb: leggen, stem, lip, heet, hemd
branch: stem, heet, lopen, week, elf
leaf: stem, worm, ring, heet, beer
birch: bakken, melken, borst, rinkelen, pakken
pine: winter, worm, beer, wolf, stem
willow: willen, roken, ingaan, rinkelen, dochter
fir: lopen, roken, bos, heet, stem
horn: roken, worm, heet, stem, pees
feather: meester, genezen, pijp, snede, redden
fur: roken, stem, oor, nut, heet
wing: ring, heet, roken, stem, boom
claw: klank, slim, plank, slapen, slank
tail: stem, ring, worm, heet, boot
egg: beer, nut, stem, worm, winter
nest: nest, stem, heet, mist, worm
lair: lief, luis, luiden, lachen, lui
animal: worm, stem, blind, beer, brief
flock: fijn, familie, buidel, afwassen, ginds
cow: worm, wolf, beer, roken, nut
bull: worm, roken, boom, wolf, beer
horse: beer, winter, worm, wolf, stem
sheep: weide, meester, heffen, beek, rinkelen
pig: worm, stem, beer, roken, nut
dog: worm, wolf, beer, teen, winter
cat: kat, bot, nat, plat, worm
bear: wolf, beer, worm, roken, winter
squirrel: slee, soms, snoek, samen, slepen
elk: lepel, melk, kammen, koken, kachel
fox: wolf, boom, roken, worm, pees
hare: roken, pees, heet, lopen, hart
mouse: worm, stem, wolf, elf, boot
wolf: wolf, worm, hart, winter, blind
bird: worm, wolf, beer, winter, stem
swarm: zwerm, rinkelen, slapen, smal, slim
chicken: beer, komen, koken, kammen, snoek
cock: roken, worm, pees, heet, boom
goose: goed, noorden, noemen, meester, rinkelen
eagle: eend, eens, einde, eindigen, reiken
duck: worm, beer, wolf, roken, boom
owl: wolf, worm, roken, beer, winter
crane: braden, dragen, kring, meester, krant
crow: roken, wolf, pees, worm, heet
cuckoo: cirkel, dooien, buidel, kraag, kammen
swan: rinkelen, zwaan, slim, kammen, slapen
fish: worm, beer, stem, nut, winter
perch: plank, rinkelen, regenen, ademen, worden
pike: elf, bot, lopen, boot, uil
snake: worm, wolf, stem, beer, elf
worm: worm, stem, roken, heet, nut
spider: spoor, spelen, spits, spiegel, spel
ant: heet, mist, pees, ader, roken
louse: ladder, lief, lente, lachen, luis
midge: midden, muts, morgen, mug, muis
fly: worm, boom, stem, blind, roken
butterfly: bitter, buidel, bemerken, brij, beneden
berry: beer, winter, nut, roken, worm
apple: beer, winter, stem, chef, nest
mushroom: midden, mug, muts, mouw, muis
onion: inham, ingaan, toon, roken, stem
seed: stem, worm, nut, beer, ring
grain: grond, gras, graven, plank, slim
hay: heet, roken, alom, pees, mist
husk: rinkelen, roken, lukken, likken, pees
pit: heet, roken, nut, mist, stem
trap: put, heet, elf, bot, lopen
noose: noemen, noorden, nooit, roken, toon
track: stem, heet, boom, roken, put
ashes: roken, pees, heet, beer, lopen
filth: rinkelen, november, ademen, slank, roeren
iron: water, worm, hard, ring, beer
gold: beer, water, hard, roken, nut
silver: beer, winter, roken, blind, ring
coal: water, slag, beer, wind, land
glass: door, beer, stem, roken, water
clay: slim, klank, plank, slank, slapen
sand: water, wind, nut, worm, mist
human: stem, blind, brief, roken, teen
man: man, roken, pees, dan, heet
woman: man, teen, beer, blind, roken
child: teen, blind, brief, week, man
boy: teen, man, beer, pees, roken
girl: teen, man, god, blind, beer
family: brief, teen, winter, stem, week
grandfather: cadeau, roken, augustus, worden, blind
grandmother: cadeau, winter, augustus, roken, blind
parents: week, teen, brief, pees, roken
father: god, roken, later, chef, dan
mother: god, teen, roken, man, blind
son: alom, roken, pees, lopen, heet
daughter: roken, later, heet, teen, brief
brother: broer, broek, broeder, brood, roeren
sister: soms, slee, samen, schrander, slepen
uncle: april, augustus, meester, dan, broer
aunt: aarde, aankomen, aanzien, aankijken, afrukken
husband: herstellen, willen, roken, pees, soep
wife: teen, olie, roken, man, later
joy: roken, dan, olie, alom, pees
laughter: beer, roken, brief, winter, god
happiness: honing, helling, houden, heden, hals
grief: golf, ginds, gieten, groot, gans
wish: roken, pees, put, heet, mist
desire: ineens, roken, ingaan, reeks, cadeau
spirit: beer, blind, roken, mist, heet
thought: heet, brief, blind, stem, later
memory: boot, stem, elf, brief, letter
mind: mist, heet, stem, god, blind
meaning: later, brief, heet, put, kind
reason: heet, later, roken, put, brief
truth: god, brief, roken, lied, blind
talk: week, brief, pop, boom, stem
fairy tale: familie, vasteland, fijn, golf, buidel
story: letter, brief, week, stem, boom
message: letter, elf, bot, fout, week
news: arts, top, brief, week, boot
name: letter, week, kind, woord, fout
puzzle: punt, pap, prikken, pijp, prijzen
speech: brief, letter, week, stem, blind
language: letter, brief, week, stem, elf
voice: brief, zee, stem, letter, week
word: worden, letter, elf, week, stem
sign: put, heet, lopen, roken, week
call: put, bot, lopen, kind, heet
noise: wind, worm, water, zee, beer
sound: boom, stem, blind, heet, wind
tone: heet, roken, olie, lopen, ring
song: letter, week, brief, heet, boom
calm: overal, ingaan, roken, rinkelen, november
people: week, man, brief, lopen, roken
nation: week, roken, lopen, heet, later
work: week, heet, stem, brief, roken
guest: week, brief, chef, top, beer
gift: beer, letter, stem, brief, week
game: ui, boot, bot, elf, uil
company: brief, week, top, heet, letter
help: brief, top, boot, stem, week
friend: week, lopen, heet, kind, roken
companion: stem, produceren, worden, storen, opdagen
matter: heet, stem, later, roken, ring
count: rand, put, week, kind, vet
sort: put, kind, rand, week, letter
piece: heet, letter, roken, lopen, stem
part: week, heet, kind, put, mist
half: blind, hard, roken, beer, warm
circle: ring, letter, stem, elf, heet
cross: stem, ring, blind, top, brief
line: letter, heet, ring, stem, elf
stroke: stem, brief, beer, week, teen
gap: stem, heet, lopen, ring, boot
distance: week, heet, stem, letter, lopen
area: week, lopen, letter, heet, top
space: beer, stem, roken, brief, top
place: put, heet, roken, lopen, stem
side: door, top, stem, ring, boom
middle: top, roken, stem, blind, winter
item: letter, week, elf, bot, stem
thing: heet, put, kind, roken, pees
fringe: fris, braden, afrukken, meester, reeks
edge: stem, heet, ring, lopen, elf
corner: door, bed, top, winter, beer
tip: lip, stem, bot, heet, pad
end: heet, later, stem, put, roken
hole: heet, ring, worm, stem, roken
angle: ring, letter, stem, door, elf
pattern: letter, elf, stem, worden, heet
size: letter, stem, rand, week, elf
length: heet, letter, week, stem, put
height: week, letter, heet, stem, kind
weight: week, heet, stem, letter, elf
amount: week, put, letter, heet, kind
heap: elf, stem, boot, bot, heet
row: week, pad, heet, rand, letter
boat: beer, door, boot, winter, boom
oar: oever, oosten, spoelen, noemen, roken
sleigh: slee, soms, samen, slepen, slijpen
ski: ski, beer, winter, wei, roken
campfire: winter, augustus, beer, drinken, baden
load: rand, put, open, elf, boot
walk: week, put, lopen, roken, boom
step: heet, stem, put, week, pad
north: westen, winter, top, hart, roken
south: westen, winter, roken, hart, eland
west: westen, hart, dan, winter, kip
east: westen, hart, roken, dan, winter
wood: door, bed, beer, water, worm
board: letter, week, boot, elf, stem
slab: slim, slank, slapen, slag, slang
bracket: braden, bruisen, brug, heet, plank
pole: ring, stem, heet, door, roken
stick: stem, ring, boot, worm, pad
staff: brief, week, chef, stem, top
pipe: door, stem, ring, worm, heet
house: door, beer, top, roken, winter
home: top, brief, zee, beer, arts
stove: strop, stomp, steken, stoten, stang
floor: door, bed, rug, ring, stem
table: letter, boot, week, stem, elf
chair: door, bed, roken, stem, heet
cradle: dragen, braden, kring, slim, plank
bed: bed, door, bederven, rug, bedekken
shelf: stem, bed, door, worm, heet
box: stem, boot, ring, elf, worm
window: ui, boot, fout, bot, elf
door: door, roken, bed, lopen, heet
gate: door, stem, ring, heet, roken
fence: fijn, familie, ladder, golf, knoop
roof: door, bed, water, beer, wind
ladder: ladder, lief, lente, luis, luiden
broom: brij, bitter, bellen, bont, buidel
spade: spoor, spelen, spits, spiegel, spel
shovel: slapen, slank, rinkelen, slim, buidel
fork: worm, stem, boot, elf, put
spoon: spoor, spelen, spits, spiegel, spel
knife: beer, stem, worm, boot, door
net: net, bot, boot, dat, vet
hook: boot, ui, elf, bot, stem
handle: put, elf, bot, lopen, letter
lock: put, roken, heet, lopen, boot
picture: letter, brief, roken, top, beeld
figure: letter, stem, week, figuur, elf
doll: roken, worm, pees, boom, heet
pouch: pap, punt, prikken, pantalon, prijzen
bundle: boot, elf, bot, letter, stem
bag: pad, heet, rug, stem, roken
bucket: heet, stem, worm, beer, boom
cover: beeld, brief, roken, letter, heet
dishes: dansen, droom, doden, dorp, delen
sack: soms, slee, samen, slijpen, schaap
cup: stem, heet, roken, nut, beer
pot: nut, heet, bot, put, roken
kettle: kammen, knoop, koken, komen, kachel
meal: week, beer, letter, stem, nest
food: beer, stem, water, top, winter
dish: beer, stem, heet, nest, roken
meat: meester, mei, meedelen, meisje, beer
corn: beer, nut, worm, roken, winter
mush: muts, mug, muis, midden, maken
bread: beer, nut, worm, stem, boom
slice: stem, elf, boot, heet, letter
fat: blind, nut, heet, beer, stem
butter: bitter, brij, bellen, bont, buidel
oil: water, beer, wind, stem, nut
salt: water, stem, nut, worm, beer
soup: beer, winter, stem, boom, worm
honey: honing, helling, heden, houden, hals
milk: midden, mug, muts, maken, morgen
tea: beer, stem, winter, zee, ski
leather: lepel, lekker, leven, leiden, lezen
wool: noemen, roeren, noorden, spoelen, roken
cloth: stem, beer, heet, roken, rug
needle: ring, stem, worm, water, hand
thread: stem, boot, ring, elf, letter
button: letter, boot, elf, bot, week
knot: knoop, koken, kammen, komen, kist
paint: rug, heet, beer, door, stem
clothes: handdoek, handvat, roeren, beer, roken
shirt: beer, heet, door, roken, stem
collar: plank, leggen, roken, heet, rinkelen
sleeve: slee, slede, slepen, slecht, slijpen
trousers: trappen, bruisen, inslapen, bederven, buidel
belt: heet, ring, stem, beer, door
cap: heet, nut, pad, roken, bot
shoe: zonde, rinkelen, schrede, plank, meester
boot: boot, bot, elf, lopen, worm
ring: ring, heet, stem, worm, roken
ribbon: stem, ring, letter, worm, elf
comb: stem, heet, mist, worm, pad
mirror: door, ring, stem, roken, heet
strap: heet, stem, pad, boot, roken
string: letter, val, elf, put, rand
leash: lepel, leeg, leven, lekker, lezen
blanket: beer, blind, brief, noorden, top
pillow: handvat, plank, beer, bedekken, bed
scarf: rinkelen, roken, handvat, bederven, ingaan
towel: tellen, tien, tong, tijd, tante
force: heet, stem, elf, blind, put
strength: heet, stem, roken, brief, put
health: brief, stem, beer, top, week
illness: later, brief, roken, ingaan, heet
pain: roken, brief, stem, beer, heet
wound: wachten, winkel, wenden, weten, wassen
fever: meester, redden, genezen, zonde, roeren
medicine: beer, stem, brief, top, roken
bridge: door, stem, heet, top, ring
well: later, heet, roken, blind, been
pasture: winter, beer, november, brief, ingaan
path: fout, elf, bot, rand, week
way: heet, roken, put, pees, lopen
road: door, blind, beer, land, winter
village: vinden, varken, vissen, vullen, vrouw
town: roken, lopen, week, land, brief
letter: letter, worden, heet, week, stem
book: brief, letter, stem, week, top
character: letter, brief, heet, stem, week
newspaper: produceren, november, april, opdagen, worden
life: zee, week, brief, beer, stem
death: blind, brief, roken, god, beer
grave: roken, olie, brief, blind, door
church: beer, brief, blind, roken, top
sin: kin, spin, lopen, roken, dan
god: god, lied, roken, blind, man
worker: elf, chef, bot, letter, week
boss: roken, bos, chef, boom, lopen
master: stem, top, lopen, roken, chef
doctor: chef, teen, roken, blind, dan
teacher: chef, teen, brief, beer, stem
money: beer, letter, week, top, stem
business: brief, top, beer, stem, week
shop: top, stem, roken, lopen, storen
price: week, top, letter, beer, stem
ware: lopen, roken, heet, pees, stem
profit: week, heet, stem, beer, lopen
wealth: brief, land, blind, week, beer
world: top, winter, week, beer, blind
country: beer, winter, top, week, blind
state: week, letter, uil, stem, brief
king: wang, kip, hart, roken, dan
power: water, beer, wind, boom, stem
border: letter, brief, stem, blind, top
war: roken, beer, oor, winter, teen
enemy: elf, blind, bot, letter, week
violence: november, roken, later, lied, noemen
fight: brief, roken, blind, week, heet
bow: roken, boom, stem, heet, worm
arrow: top, letter, roken, beeld, brief
gun: beer, roken, worm, boom, blind
mistake: mist, roken, heet, ingaan, noemen
lie: lied, olie, hoe, heet, roken
damage: heet, stem, roken, brief, lopen
misfortune: misleiden, ingaan, roken, meester, noemen
fault: heet, stem, brief, worm, elf
age: week, letter, kind, stem, heet
conclusion: heet, ingaan, brief, lopen, worden
time: week, letter, elf, stem, heet
day: week, heet, dag, kind, lopen
morning: april, november, winter, herfst, roken
noon: roken, lopen, week, heet, boom
evening: brief, roken, winter, overal, noemen
night: winter, blind, week, beer, brief
week: week, brief, heet, lopen, beer
month: week, letter, last, vet, kind
year: week, letter, kind, heet, brief
spring: springen, winter, stem, boot, worm
summer: winter, beer, week, brief, stem
autumn: winter, november, april, augustus, december
winter: winter, beer, warm, water, wolf
January: winter, week, brief, beer, last
February: winter, week, brief, beer, last
March: winter, week, eland, beer, hart
April: winter, week, beer, ei, of
May: later, of, as, roken, winter
June: winter, week, olie, roken, of
July: winter, week, beer, brief, last
August: winter, week, later, of, roken
September: winter, week, brief, beer, beeld
October: winter, week, beer, brief, last
November: winter, week, brief, beer, of
December: winter, week, brief, beer, december
Monday: winter, week, brief, roken, later
Tuesday: winter, week, brief, roken, later
Wednesday: winter, week, brief, roken, later
Thursday: winter, week, brief, roken, beer
Friday: winter, week, brief, roken, beer
Saturday: winter, week, brief, roken, beer
Sunday: winter, week, brief, beer, roken
big: blind, top, boom, beer, roken
little: blind, roken, winter, teen, brief
long: brief, roken, heet, stem, blind
short: brief, blind, stem, heet, roken
wide: roken, blind, stem, heet, brief
narrow: negen, nog, nacht, nemen, niet
dense: stem, hard, ring, warm, heet
thick: thans, roken, heet, honing, slim
thin: roken, warm, stem, heet, hard
delicate: roken, lepel, deken, aarde, cadeau
firm: heet, roken, lopen, stem, later
flat: stem, heet, ring, hard, plat
smooth: blind, roken, warm, hard, stem
hard: hard, warm, blind, stem, roken
soft: hard, warm, blind, stem, roken
round: ring, warm, bed, roken, door
pointed: heet, roken, worden, ring, ingaan
sharp: roken, blind, heet, stem, boom
blunt: blazen, blaffen, blad, blauw, slim
heavy: hard, blind, stem, beer, warm
beautiful: roken, warm, winter, blind, brief
hot: warm, top, stem, heet, roken
warm: warm, winter, roken, hard, blind
cold: warm, hard, winter, blind, beer
cool: warm, top, winter, roken, boom
fresh: warm, winter, roken, beer, blind
damp: droom, dorp, dansen, drek, dier
wet: wassen, wenden, weten, wensen, wachten
dry: warm, hard, stem, worm, water
full: brief, top, blind, last, stem
empty: stem, elf, letter, top, put
open: open, openen, lopen, roken, boot
closed: roken, brief, blind, lopen, heet
clean: boot, put, top, lopen, stem
dirty: blind, beer, roken, winter, warm
raw: put, stem, warm, nut, top
ripe: stem, roken, lopen, zee, beer
delicious: drinken, beloven, lepel, lekker, melken
sweet: warm, winter, blind, beer, roken
bitter: bitter, brij, bellen, bont, beneden
sour: soms, slee, samen, smeren, slijpen
bright: warm, blind, winter, brief, roken
dark: blind, warm, hard, wolf, winter
black: blind, roken, warm, top, winter
white: warm, roken, winter, olie, blind
red: reden, roken, blind, winter, wolf
yellow: winter, warm, roken, beer, reden
blue: roken, winter, olie, beer, warm
green: roken, winter, beer, stem, lopen
grey: winter, roken, warm, door, beer
colourful: worden, winter, beer, stem, letter
cheap: top, mens, roken, winter, brief
dear: deken, deur, deel, deksel, tehuis
precious: roken, december, november, heet, noemen
blind: blind, roken, brief, stem, heet
deaf: deken, deur, deel, deksel, rede
powerful: brief, blind, overal, top, produceren
strong: brief, roken, stem, blind, heet
weak: blind, brief, stem, heet, roken
slim: slim, slank, slapen, slang, sluiten
pretty: top, put, blind, warm, roken
evil: blind, roken, god, teen, beer
stupid: stang, stomp, sturen, stoten, stier
lazy: blind, stem, boot, elf, chef
diligent: dansen, drijven, dertig, dier, dood
stingy: stoten, stang, stomp, strop, steken
clever: roken, herstellen, reeks, ingaan, lepel
skilful: rinkelen, buidel, klank, slapen, kledij
merry: midden, mug, morgen, muts, muis
gentle: roken, ingaan, noemen, heet, rinkelen
hungry: honger, hangen, blind, wang, hongerig
sick: soms, slee, samen, slijpen, smeren
naked: negen, nog, nemen, nacht, niet
sad: roken, blind, pad, pees, oor
living: roken, blind, stem, brief, winter
good: blind, brief, top, roken, heet
bad: baden, blind, roken, pad, brief
correct: put, heet, brief, blind, stem
nasty: nog, negen, nemen, nacht, niet
true: blind, brief, roken, stem, zee
old: roken, blind, top, brief, oud
new: top, brief, roken, lopen, put
former: of, roken, later, as, thee
aged: roken, blind, put, warm, of
young: teen, blind, roken, top, hart
poor: poort, noemen, spoelen, dochter, noorden
rich: roken, blind, dan, pees, alom
familiar: familie, fijn, roken, ginds, brief
famous: fijn, familie, golf, komen, ginds
foreign: top, brief, blind, stem, teen
different: of, later, heet, brief, roken
near: roken, of, lopen, heet, beeld
far: roken, oor, tal, lopen, kin
left: top, blind, put, stem, roken
right: heet, stem, blind, roken, top
other: of, brief, later, roken, as
first: last, top, brief, week, blind
second: last, brief, blind, later, top
third: last, brief, blind, roken, later
last: last, brief, week, blind, top
alone: roken, later, heet, brief, lopen
at once: of, andere, ingaan, later, as
together: toon, toen, toenemen, toebereiden, tooien
suddenly: slee, soms, samen, slijpen, slepen
instantly: overal, brief, beer, blind, heet
later: later, heet, roken, of, been
now: later, heet, put, roken, week
today: week, later, roken, heet, lopen
tomorrow: willen, dan, augustus, april, lukken
soon: later, roken, heet, lopen, oor
then: later, of, been, heet, roken
yesterday: oever, soep, hiel, willen, roken
once: later, been, roken, heet, as
at that time: of, andere, ingaan, thee, later
afterwards: later, of, ingaan, toon, willen
before: later, week, put, last, blind
at first: of, later, andere, as, ingaan
sometimes: later, of, as, put, been
often: been, later, of, as, roken
always: been, later, put, heet, pees
never: been, later, god, we, roken
here: later, roken, heet, week, lopen
hither: houden, helling, heden, honing, hout
hence: honing, houden, heden, helling, hout
there: been, later, we, god, roken
thither: thans, bruisen, roken, ingaan, ophouden
ahead: lopen, roken, heet, week, stem
forward: blind, brief, stem, heet, lopen
backward: beeld, brief, week, roken, heet
below: later, heet, brief, roken, of
down: roken, heet, put, lopen, boom
above: roken, heet, brief, later, put
up: top, lopen, stem, week, put
everywhere: noemen, thee, roken, herstellen, ingaan
not: been, later, put, as, of
a little: aarde, thee, aankijken, aanzien, aankomen
hardly: hard, overal, roken, blind, warm
very: been, tooien, later, as, of
so: soep, soort, tooien, later, put
still: been, later, roken, heet, blind
only: later, of, put, roken, heet
already: been, later, heet, roken, week
again: later, heet, roken, put, lopen
in vain: inham, of, ingaan, later, andere
in front of: inham, of, ingaan, andere, thee
behind: roken, ingaan, herstellen, willen, heet
under: of, overal, as, roken, onder
through: of, later, as, brief, heet
next to: of, thee, toon, inham, andere
between: of, as, later, roken, brief
because of: of, as, andere, later, ingaan
this: heet, lopen, put, brief, kind
that: of, later, as, heet, roken
everything: roken, heet, put, later, lopen
I: we, been, weer, ijs, weide
you: we, later, been, roken, pees
thou: thans, roken, ophouden, zonde, tooien
he: heffen, of, later, thee, as
we: we, weide, weer, wekken, been
they: we, been, later, heet, pees
what: of, later, heet, put, roken
who: we, been, later, man, weide
where: of, as, later, put, roken
where ... to: andere, toenemen, toen, of, toon
how: of, put, as, later, heet
why: of, put, later, as, roken
how much: of, ingaan, as, dochter, doof
one: roken, zee, olie, heet, brief
two: roken, blind, brief, of, heet
three: roken, heet, brief, stem, blind
four: roken, heet, brief, blind, top
five: roken, brief, top, zee, heet
six: roken, brief, heet, blind, top
seven: roken, brief, heet, blind, top
eight: roken, heet, brief, top, of
nine: roken, zee, brief, olie, heet
ten: roken, lopen, heet, top, eten
eleven: leven, roken, reeks, lopen, ineens
twelve: twintig, twijg, roken, november, reeks
twenty: week, top, roken, beer, winter
thirty: thans, roken, november, heet, zonde
forty: augustus, roken, westen, april, hart
fifty: fijn, familie, golf, zuster, vijf
sixty: roken, brief, top, april, overal
seventy: september, zeventig, ineens, veertig, twintig
eighty: roken, overal, brief, top, reeks
ninety: zeventig, roken, zuster, november, ademen
a hundred: aarde, thee, aanzien, aankijken, aankomen
a thousand: aarde, thee, aanzien, aankijken, aankomen
and: of, later, andere, as, been
or: of, later, oor, as, been
stand: roken, heet, lied, put, lopen
sit: dit, heet, pees, alom, put
hang: hangen, put, heet, roken, wang
become: beek, bezem, beven, tooien, ingaan
happen: houden, honing, helling, heden, hout
begin: beginnen, put, bot, lopen, rand
change: put, lopen, heet, letter, boot
rise: roken, zee, lopen, stem, boom
set: put, rand, val, bot, fout
shine: roken, zee, olie, boom, heet
blow: blazen, blaffen, blad, blauw, slim
stream: heet, stem, lopen, elf, put
flow: heet, stem, ring, wind, water
revolve: rinkelen, vasteland, slapen, november, regenen
sway: slapen, slim, rinkelen, zonde, plank
swing: boom, ring, roken, door, stem
fall: winter, beer, stem, week, top
burn: roken, put, heet, worm, pees
freeze: stem, boot, put, hoe, heet
thaw: thans, heet, roken, zonde, rinkelen
melt: midden, muts, maken, mug, macht
boil: boog, boord, boek, boven, boezem
rot: rotten, heet, lopen, roken, bot
decay: heet, stem, ring, roken, worm
snap: boot, boom, stem, bot, pop
sink: bed, door, roken, rug, heet
pass: put, lopen, heet, week, bot
appear: put, later, heet, roken, lopen
disappear: redden, roken, reiken, pees, lopen
decrease: deken, deur, deel, deksel, rede
increase: put, stem, of, brief, heet
grow: stem, put, roken, boom, beer
sparkle: worden, rinkelen, elf, slapen, figuur
be noisy: beven, bezem, beek, beheersen, tooien
chime: zonde, koken, schrede, buidel, meedelen
tinkle: tellen, tien, tante, tong, tillen
roar: roeren, rook, roep, rood, roepen
rustle: rust, rinkelen, slapen, worden, stomp
howl: soep, tooien, doof, willen, roken
whistle: slapen, meester, komen, fluiten, zonde
shout: schudden, jij, slank, rinkelen, heet
groan: groen, roeren, broer, rook, droog
tremble: tellen, tillen, tong, tijding, tien
be alive: beven, bezem, beek, beheersen, bezoeken
be born: beven, beek, bezem, been, beheersen
breathe: buidel, bemerken, beneden, bellen, beproeven
drink: drinken, beer, week, stem, heet
eat: beer, nat, drinken, roken, pees
swallow: rinkelen, roken, slapen, slim, rook
get tired: put, week, brief, stoppen, overal
fall asleep: winter, beer, november, drinken, week
wake up: roken, noemen, doof, boom, drinken
get up: put, heet, overal, roken, doof
relax: optillen, plank, regenen, slapen, korrel
fall ill: winter, november, roken, herfst, beer
be ill: beven, beek, bezem, been, beheersen
ache: roken, heet, olie, zee, lopen
cough: cirkel, knoop, bitter, honing, komen
recover: put, boot, roken, lopen, stem
die: olie, wie, hoe, lopen, zee
perish: herstellen, ingaan, noemen, roken, inham
move: put, lopen, elf, heet, boot
budge: bellen, buidel, brij, bont, beneden
stand up: roken, ingaan, boom, bang zijn, leder
sit down: ingaan, herstellen, bang zijn, roken, lied
tumble: tellen, tien, tijd, tong, tussen
pace: roken, olie, heet, lopen, zee
go for a walk: goed, toedekken, aandrijven, aankijken, dochter
rush: roken, boom, pees, stem, heet
hurry: honing, houden, helling, hout, heden
dash: pad, lopen, elf, boot, boom
run: put, boot, bot, lopen, elf
jump: boot, boom, stem, week, heet
climb: klank, slapen, plank, slim, buidel
seesaw: september, reeks, meedelen, ineens, omheining
creep: heet, rook, rinkelen, redden, streep
swim: slim, golf, rinkelen, komen, slank
dive: dansen, droom, dorp, doden, dak
drive: boot, stem, roken, heet, boom
go: goed, zee, lopen, zo, roken
go away: goed, doof, dochter, noemen, tooien
depart: put, lopen, heet, roken, alom
stop: stoppen, stem, blind, put, top
go in: goed, noemen, doof, tooien, dochter
enter: put, lopen, later, roken, heet
come: olie, later, roken, rede, hoe
arrive: worden, week, lopen, praten, hitte
come back: toenemen, tooien, herstellen, bang zijn, later
stay: week, brief, roken, been, heet
wait: put, week, heet, bot, kind
wait for: put, later, heet, noemen, of
seek: put, heet, kind, lopen, roken
look for: put, of, ingaan, soep, roken
find: put, top, kind, blind, stem
try: put, week, heet, stem, lopen
prepare: put, stem, heet, lopen, brief
love: zee, olie, roken, beer, teen
like: of, roken, put, later, as
laugh: laars, noemen, staart, cadeau, traan
weep: roken, heet, pees, mist, worm
grumble: grond, graven, gras, slank, slapen
be annoyed: beven, bezem, beek, beheersen, been
be afraid: beven, beek, bezem, beheersen, bezoeken
be afraid of: beheersen, beven, bezem, beek, bezitten
flee: fijn, familie, slee, ginds, koe
escape: lopen, elf, stem, roken, heet
see: roken, of, lopen, oor, thee
look at: put, soep, dochter, of, tooien
watch: roken, beeld, brief, blind, teen
hear: oor, roken, heet, brief, lopen
listen: roken, lopen, week, brief, put
taste: tante, tellen, tien, tijd, twee
smell: smal, smelten, heet, slim, slapen
feel: put, roken, heet, been, later
seem: september, bezem, beek, beven, ineens
show: boot, put, elf, brief, letter
be cold: beven, beek, bezem, been, beheersen
do: doof, doen, dochter, doek, put
can: of, later, roken, put, willen
want: put, heet, kind, roken, pees
start: week, bot, beginnen, top, last
finish: heet, stem, put, roken, letter
succeed: soms, slee, slijpen, samen, slepen
turn out: put, ingaan, roken, heet, later
close: brief, put, roken, lopen, top
put: put, heet, roken, lopen, kind
lay: put, heet, roken, lied, pees
touch: boot, elf, put, bot, stem
connect: lopen, boot, nest, put, stem
hang up: hangen, bang zijn, roken, put, bedekken
pick up: put, ingaan, roken, doof, drinken
leave: put, roken, heet, lopen, brief
lose: put, roken, heet, lopen, brief
make: put, lopen, stem, roken, brief
produce: stem, heet, of, brief, roken
build: boot, elf, put, stem, rust
mend: muts, mug, muis, maken, mier
improve: overal, inham, ingaan, stoppen, put
alter: put, lopen, stem, heet, roken
dig: oog, dag, pees, alom, lopen
bend: bont, brij, bellen, beneden, buidel
spin: spin, ring, stem, kin, heet
turn: put, heet, roken, kind, stem
turn around: put, roken, ingaan, heet, doof
raise: put, elf, kind, lopen, heet
lift: heet, stem, boom, roken, ring
seize: september, ineens, reeks, nevel, noemen
hold: put, roken, heet, lopen, lied
press: brief, pees, roken, stem, lopen
push: put, bot, boot, rand, pop
scrape: bot, boot, storen, spoor, spelen
lick: roken, pees, heet, lopen, put
bite: roken, olie, zee, stem, boom
tear off: teken, tehuis, tegelijk, tekenen, tevergeefs
cut off: put, roken, heet, ingaan, stem
tie: olie, roken, ring, heet, hoe
break: put, roken, week, heet, stem
knock: knook, knokken, roken, komen, rinkelen
hit: hitte, heet, put, roken, pad
glue: glad, glanzen, slim, plank, slapen
rub: pees, roken, mist, put, heet
spread: put, heet, stem, blind, roken
grind: grond, gras, graven, honing, slim
cut: put, nut, stem, heet, roken
jolt: jij, jagen, juli, juni, jullie
shake: roken, beer, olie, boom, zee
pour: of, oor, heet, put, roken
fill: put, heet, stem, roken, lopen
wrap: put, boot, elf, stem, heet
carry: put, roken, heet, stem, lopen
drag: dag, stem, put, heet, pad
pull: put, stem, pad, heet, boot
keep: put, blind, roken, stem, heet
throw: put, heet, stem, elf, boot
catch: put, heet, elf, lopen, week
grab: put, roken, heet, lopen, pad
hide: put, lopen, roken, top, elf
divide: put, lopen, stem, roken, heet
send: put, rand, bot, kind, lopen
bring: put, roken, heet, lopen, brief
add: put, elf, bot, rand, pad
get: put, bot, vet, top, last
receive: put, brief, of, heet, lopen
take: put, roken, heet, lopen, brief
choose: put, lopen, roken, heet, stem
select: put, lopen, week, vet, brief
preserve: lopen, brief, put, elf, last
hinder: hinderen, honing, houden, heden, helling
spoil: spoor, spits, spelen, spel, spiegel
destroy: put, roken, lopen, heet, stem
give: put, roken, brief, of, lopen
promise: lopen, letter, elf, stem, zee
praise: praten, pralen, meester, noemen, zonde
kiss: komen, koken, kammen, kist, knoop
rock: worm, beer, stem, ring, boom
wake: roken, zee, olie, stem, boom
guide: stem, brief, lopen, roken, heet
teach: teken, tehuis, tekenen, tevergeefs, tegelijk
instruct: inham, of, inwikkelen, ingaan, toon
bring up: put, ingaan, dochter, herstellen, noemen
lead: stem, heet, top, blind, brief
urge: roken, heet, later, put, lopen
let: val, of, put, later, oor
invite: letter, put, week, lopen, kind
unite: redden, reiken, noemen, lopen, roken
visit: roken, lopen, heet, beeld, top
meet: roken, oor, as, of, heet
assemble: lopen, stem, put, heet, elf
play: roken, lopen, blind, heet, put
sing: heet, roken, put, lied, pees
dance: beer, zee, teen, ski, winter
separate: september, noemen, reeks, lopen, roken
rescue: reeks, worden, redden, regenen, reiken
guard: heet, roken, put, stem, lopen
protect: put, roken, heet, lopen, stem
defend: blind, put, brief, of, vet
brawl: bellen, brij, buidel, bitter, bont
shoot: put, heet, roken, pees, boom
win: lopen, put, roken, boot, kin
annoy: willen, rennen, rinkelen, dan, noemen
beat: heet, stem, beer, roken, boom
kick: roken, boom, heet, pees, put
sting: stang, stoten, stof, strop, stelen
shove: zonde, roken, schrede, rinkelen, slapen
steal: steun, steunen, ze, lopen, zee
disturb: heet, put, mist, bot, regenen
bother: boog, boord, boezem, boek, boven
conceal: repareren, reinigen, ineens, redden, proberen
deceive: deken, deur, deel, deksel, rede
cheat: cadeau, meester, hitte, noemen, reeks
kill: put, blind, roken, heet, boot
dwell: droom, dansen, dorp, doden, dood
gather: put, lopen, stem, roken, heet
pick: put, roken, heet, pees, stem
hunt: roken, hart, lopen, heet, boom
herd: herstellen, herfst, herkennen, ingaan, noemen
tie up: roken, hitte, hangen, noemen, ingaan
feed: stem, beer, boot, worm, nest
chop: roken, stem, heet, boom, pees
ripen: riem, roken, roeren, lopen, redden
cook: chef, roken, lopen, stem, put
bake: bellen, brij, bitter, bont, buidel
fry: fijn, familie, buidel, koken, ginds
stir: strop, stang, stoten, sturen, stier
knit: knook, knokken, komen, roken, koken
sew: september, bezem, beek, soep, ineens
dye: drie, dorp, dansen, droom, doden
wash: roken, heet, pees, put, stem
wipe: put, boot, elf, stem, roken
rinse: rinkelen, drinken, roken, rennen, hitte
sweep: slee, soms, slijpen, samen, slepen
bath: bitter, brij, bellen, bont, buidel
take off: put, noemen, roken, ingaan, doof
put on: put, ingaan, of, roken, noemen
get dressed: put, brief, roken, worden, doof
decorate: roken, put, stem, door, lopen
say: put, heet, alom, oor, kind
speak: slee, soms, samen, spreken, slijpen
chat: bot, dat, plat, boot, lopen
ask: put, lopen, chef, alom, blind
request: ui, bot, letter, elf, fout
tell: put, blind, lopen, oor, roken
convey: heet, ingaan, put, roken, lopen
brag: braden, brug, bruisen, buidel, ginds
translate: bot, elf, lopen, boot, brief
think: boom, stem, brief, heet, blind
believe: beloven, willen, noemen, roken, nevel
notice: letter, lopen, put, brief, heet
recognize: noemen, put, ingaan, later, of
grasp: gras, grond, graven, plank, ginds
understand: overal, of, ingaan, inham, put
learn: lopen, put, brief, stem, top
know: put, roken, heet, brief, kind
remember: roken, put, later, heet, brief
forget: put, roken, heet, later, lopen
measure: heet, put, stem, lopen, letter
calculate: stem, put, heet, letter, rand
read: put, brief, lopen, heet, kind
draw: put, heet, elf, stem, lopen
write: put, letter, brief, elf, rand
own: roken, put, heet, lopen, brief
buy: roken, top, of, stem, brief
sell: roken, put, heet, stem, top
pay for: ingaan, of, dochter, overal, put
pay: put, heet, pees, roken, lopen
rule: heet, put, elf, letter, lopen
endure: ingaan, stoppen, heet, noemen, roken
